ranker,player,nationality,position,team,age,birth_year,minutes_90s,tackles,tackles_won,tackles_def_3rd,tackles_mid_3rd,tackles_att_3rd,challenge_tackles,challenges,challenge_tackles_pct,challenges_lost,blocks,blocked_shots,blocked_passes,interceptions,tackles_interceptions,clearances,errors,matches
1,Luis Abram,pe PER,DF,Atlanta Utd,26,1996,16.2,12,9,9,2,1,8,13,61.5,5,24,11,13,16,28,52,0,Matches
2,Lalas Abubakar,gh GHA,DF,Colorado Rapids,28,1994,21.3,22,11,17,5,0,13,18,72.2,5,23,17,6,34,56,61,2,Matches
3,Alonso Aceves,mx MEX,DF,Chicago Fire,21,2001,9.5,29,20,22,7,0,11,24,45.8,13,21,8,13,15,44,34,0,Matches
4,Bryan Acosta,hn HON,MF,Colorado Rapids,29,1993,12.4,22,15,14,7,1,6,16,37.5,10,17,5,12,7,29,14,1,Matches
5,Bryan Acosta,hn HON,MF,Portland Timbers,29,1993,5.1,18,12,5,11,2,12,23,52.2,11,4,2,2,8,26,4,0,Matches
6,Kellyn Acosta,us USA,MF,LAFC,27,1995,16.6,34,20,13,15,6,17,33,51.5,16,22,2,20,18,52,11,0,Matches
7,Luciano Acosta,ar ARG,MF,FC Cincinnati,28,1994,28.9,36,19,18,9,9,13,41,31.7,28,22,1,21,18,54,3,1,Matches
8,Sam Adekugbe,ca CAN,FWDF,Vancouver W'caps,28,1995,4.5,4,3,2,2,0,1,3,33.3,2,4,1,3,7,11,10,0,Matches
9,Samuel Adeniran,us USA,FW,St. Louis,24,1998,10.5,7,4,3,3,1,3,6,50.0,3,6,0,6,3,10,8,0,Matches
10,Harrison Afful,gh GHA,DF,Charlotte,36,1986,10.6,11,7,4,5,2,7,19,36.8,12,10,2,8,22,33,26,1,Matches
11,Stephen Afrifa,ca CAN,FW,Sporting KC,21,2001,0.6,0,0,0,0,0,0,0,,0,1,0,1,1,1,1,0,Matches
12,William Agada,ng NGA,FW,Sporting KC,23,1999,7.6,3,2,1,1,1,1,5,20.0,4,6,2,4,2,5,1,0,Matches
13,Giovanni Aguilar,us USA,MF,Vancouver W'caps,24,1998,0.1,1,1,1,0,0,0,0,,0,0,0,0,0,1,0,0,Matches
14,Daniel Aguirre,us USA,MFFW,LA Galaxy,23,1999,6.4,8,2,5,3,0,5,8,62.5,3,10,2,8,6,14,6,0,Matches
15,Patrick Agyemang,us USA,FW,Charlotte,22,2000,2.1,0,0,0,0,0,0,1,0.0,1,2,0,2,0,0,3,0,Matches
16,Ali Ahmed,ca CAN,MFDF,Vancouver W'caps,22,2000,12.5,37,27,10,16,11,15,25,60.0,10,13,2,11,18,55,1,0,Matches
17,Carlos Akapo,gq EQG,DF,SJ Earthquakes,29,1993,23.8,61,37,37,13,11,30,56,53.6,26,32,7,25,42,103,79,1,Matches
18,Matai Akinmboni,us USA,DF,D.C. United,16,2006,2.0,1,1,0,1,0,1,1,100.0,0,2,2,0,1,2,6,0,Matches
19,Ayo Akinola,ca CAN,FW,Toronto FC,23,2000,6.2,1,1,0,1,0,0,2,0.0,2,5,0,5,0,1,3,0,Matches
20,Ayo Akinola,ca CAN,FWMF,SJ Earthquakes,23,2000,0.6,3,1,3,0,0,1,1,100.0,0,2,1,1,0,3,2,0,Matches
21,Joey Akpunonu,us USA,DF,FC Cincinnati,21,2001,0.1,0,0,0,0,0,0,0,,0,0,0,0,0,0,0,0,Matches
22,Jordi Alba,es ESP,DF,Inter Miami,33,1989,4.9,9,5,5,4,0,4,7,57.1,3,2,0,2,1,10,9,0,Matches
23,Tony Alfaro,us USA,DF,NYCFC,29,1993,4.2,4,1,3,1,0,2,6,33.3,4,4,3,1,4,8,12,0,Matches
24,Tony Alfaro,us USA,DF,LA Galaxy,29,1993,4.2,4,3,2,2,0,2,6,33.3,4,8,7,1,5,9,19,0,Matches
25,Noah Allen,us USA,DF,Inter Miami,18,2004,13.9,35,16,23,10,2,19,32,59.4,13,13,2,11,14,49,33,0,Matches
Rk
26,Rasmus Alm,se SWE,MFFW,St. Louis,27,1995,12.2,19,12,8,9,2,9,24,37.5,15,20,0,20,5,24,6,0,Matches
27,Thiago Almada,ar ARG,MF,Atlanta Utd,21,2001,30.3,24,14,5,11,8,9,32,28.1,23,11,1,10,9,33,1,2,Matches
28,Osvaldo Alonso,cu CUB,MF,Atlanta Utd,37,1985,1.1,2,2,0,1,1,0,4,0.0,4,4,3,1,0,2,1,0,Matches
29,Jozy Altidore,us USA,FW,NE Revolution,33,1989,2.3,0,0,0,0,0,0,2,0.0,2,0,0,0,0,0,0,0,Matches
30,Efrain Alvarez,mx MEX,MFFW,LA Galaxy,20,2002,4.2,1,0,0,1,0,0,5,0.0,5,3,0,3,3,4,0,0,Matches
31,Fernando Álvarez,co COL,DF,CF Montréal,19,2003,2.8,3,2,1,2,0,1,2,50.0,1,5,2,3,7,10,11,0,Matches
32,Luis Amarilla,py PAR,FW,Minnesota Utd,27,1995,8.2,5,3,1,3,1,1,11,9.1,10,3,0,3,0,5,8,0,Matches
33,Frankie Amaya,us USA,MF,NY Red Bulls,22,2000,21.3,43,23,15,21,7,24,50,48.0,26,23,3,20,27,70,29,0,Matches
34,Malte Amundsen,dk DEN,DF,Columbus Crew,24,1998,21.0,39,25,21,18,0,22,40,55.0,18,28,11,17,45,84,66,3,Matches
35,Sebastian Anderson,us USA,DF,Colorado Rapids,20,2002,3.0,5,2,2,2,1,2,4,50.0,2,3,1,2,1,6,16,0,Matches
36,José Andrés Martínez,ve VEN,MF,Philadelphia Union,28,1994,20.3,52,30,30,19,3,31,56,55.4,25,26,10,16,33,85,18,1,Matches
37,Iván Angulo,co COL,FWDF,Orlando City,23,1999,27.6,32,17,17,10,5,14,36,38.9,22,32,3,29,17,49,19,0,Matches
38,Marco Angulo,ec ECU,MF,FC Cincinnati,20,2002,8.7,20,15,10,8,2,9,16,56.3,7,12,1,11,14,34,5,2,Matches
39,Eugene Ansah,gh GHA,FW,FC Dallas,28,1994,2.0,2,2,1,1,0,0,1,0.0,1,4,0,4,1,3,1,0,Matches
40,Themi Antonoglou,ca CAN,DFMF,Toronto FC,21,2001,5.3,10,5,2,6,2,6,15,40.0,9,7,1,6,5,15,9,0,Matches
41,Antony,br BRA,FWMF,Portland Timbers,21,2001,2.8,4,3,1,3,0,3,10,30.0,7,4,0,4,3,7,1,0,Matches
42,Brian Anunga,cm CMR,MF,Nashville SC,26,1996,6.3,14,10,7,6,1,8,17,47.1,9,6,3,3,11,25,4,0,Matches
43,Cristian Arango,co COL,FW,Real Salt Lake,27,1995,8.4,11,8,2,3,6,5,8,62.5,3,7,1,6,2,13,8,0,Matches
44,César Araujo,uy URU,MF,Orlando City,21,2001,30.3,51,31,20,23,8,29,91,31.9,62,40,7,33,23,74,31,0,Matches
45,Luiz Araújo,br BRA,FW,Atlanta Utd,26,1996,14.1,20,12,7,12,1,7,20,35.0,13,7,0,7,8,28,1,0,Matches
46,Miguel Araujo,pe PER,DF,Portland Timbers,28,1994,1.9,4,2,1,2,1,2,2,100.0,0,1,1,0,2,6,1,0,Matches
47,Scott Arfield,ca CAN,MFFW,Charlotte,34,1988,4.6,2,2,0,1,1,0,4,0.0,4,9,1,8,3,5,4,0,Matches
48,Maximilian Arfsten,us USA,DFMF,Columbus Crew,21,2001,3.1,7,3,4,3,0,5,9,55.6,4,0,0,0,7,14,2,0,Matches
49,Santiago Arias,co COL,DF,FC Cincinnati,31,1992,18.4,37,26,15,15,7,14,29,48.3,15,19,3,16,29,66,25,0,Matches
50,Xavier Arreaga,ec ECU,DFMF,Seattle Sounders,28,1994,3.9,6,6,4,2,0,3,4,75.0,1,2,1,1,1,7,6,0,Matches
Rk
51,Kervin Arriaga,hn HON,MF,Minnesota Utd,25,1998,13.0,16,10,7,9,0,5,19,26.3,14,14,5,9,14,30,29,3,Matches
52,Paul Arriola,us USA,FWMF,FC Dallas,27,1995,18.4,22,16,7,11,4,11,28,39.3,17,9,1,8,10,32,9,0,Matches
53,Dixon Arroyo,ec ECU,MF,Inter Miami,30,1992,19.9,41,32,19,19,3,20,62,32.3,42,29,8,21,27,68,24,0,Matches
54,Artur,br BRA,MF,Houston Dynamo,26,1996,30.3,70,44,35,27,8,27,53,50.9,26,33,11,22,44,114,42,0,Matches
55,Yamil Asad,ar ARG,MFFW,D.C. United,28,1994,5.8,10,4,1,6,3,5,23,21.7,18,9,0,9,4,14,3,1,Matches
56,Dairon Asprilla,co COL,FWMF,Portland Timbers,30,1992,16.1,23,14,9,8,6,8,26,30.8,18,18,0,18,10,33,13,0,Matches
57,Joshua Atencio,us USA,MF,Seattle Sounders,21,2002,10.9,41,28,12,21,8,21,38,55.3,17,15,2,13,16,57,14,0,Matches
58,Julián Aude,ar ARG,DF,LA Galaxy,19,2003,13.3,27,18,17,9,1,19,38,50.0,19,20,5,15,19,46,29,0,Matches
59,Tomás Avilés,ar ARG,DF,Inter Miami,18,2004,9.7,24,15,16,7,1,16,27,59.3,11,9,5,4,19,43,10,0,Matches
60,David Ayala,ar ARG,MF,Portland Timbers,20,2002,1.8,8,5,2,5,1,2,6,33.3,4,4,0,4,4,12,3,0,Matches
61,Edison Azcona,do DOM,MFDF,Inter Miami,19,2003,0.6,3,1,0,2,1,0,3,0.0,3,1,0,1,0,3,0,0,Matches
62,Dominique Badji,sn SEN,FW,FC Cincinnati,30,1992,10.2,12,7,3,4,5,5,12,41.7,7,7,0,7,1,13,8,0,Matches
63,Corey Baird,us USA,FW,Houston Dynamo,27,1996,25.9,23,17,7,12,4,14,47,29.8,33,15,0,15,8,31,14,0,Matches
64,Esmir Bajraktarevic,ba BIH,FWMF,NE Revolution,17,2005,5.5,7,6,3,2,2,3,5,60.0,2,0,0,0,1,8,0,0,Matches
65,Cody Baker,us USA,DF,Seattle Sounders,19,2004,7.6,18,13,11,6,1,11,17,64.7,6,7,3,4,4,22,20,0,Matches
66,Reed Baker-Whiting,us USA,DFFW,Seattle Sounders,17,2005,7.1,20,14,13,6,1,8,16,50.0,8,8,0,8,6,26,17,0,Matches
67,Monsef Bakrar,dz ALG,FW,NYCFC,22,2001,8.4,2,0,0,2,0,0,1,0.0,1,2,0,2,2,4,4,0,Matches
68,Michael Baldisimo,ph PHI,MF,SJ Earthquakes,22,2000,3.3,11,6,4,7,0,5,14,35.7,9,7,2,5,5,16,8,0,Matches
69,Tai Baribo,il ISR,FWMF,Philadelphia Union,25,1998,1.7,1,0,0,1,0,0,4,0.0,4,3,0,3,0,1,3,0,Matches
70,Tom Barlow,us USA,FW,NY Red Bulls,27,1995,20.5,11,6,3,6,2,4,13,30.8,9,10,1,9,5,16,11,0,Matches
71,Luis Barraza,us USA,GK,NYCFC,26,1996,24.0,0,0,0,0,0,0,0,,0,0,0,0,1,1,12,1,Matches
72,Álvaro Barreal,ar ARG,DF,FC Cincinnati,22,2000,31.3,50,34,28,17,5,28,70,40.0,42,52,4,48,36,86,52,0,Matches
73,Michael Barrios,co COL,FWMF,Colorado Rapids,31,1991,9.3,5,3,3,2,0,4,12,33.3,8,7,0,7,5,10,2,0,Matches
74,Michael Barrios,co COL,FWMF,LA Galaxy,31,1991,1.3,3,3,0,1,2,2,2,100.0,0,1,0,1,0,3,1,0,Matches
75,Lucas Bartlett,us USA,DF,St. Louis,25,1997,11.9,18,11,13,5,0,14,22,63.6,8,24,9,15,25,43,51,0,Matches
Rk
76,Ethan Bartlow,us USA,DF,Houston Dynamo,22,2000,22.1,14,10,9,4,1,5,13,38.5,8,22,17,5,13,27,102,1,Matches
77,Cole Bassett,us USA,MFFW,Colorado Rapids,21,2001,21.1,37,23,21,10,6,11,34,32.4,23,15,2,13,8,45,15,0,Matches
78,Amine Bassi,fr FRA,MFFW,Houston Dynamo,25,1997,22.2,14,7,3,8,3,8,24,33.3,16,15,1,14,11,25,3,1,Matches
79,Jesús Batiz,hn HON,MFFW,Toronto FC,23,1999,0.7,1,1,0,1,0,0,0,,0,2,1,1,0,1,0,0,Matches
80,Josh Bauer,us USA,DF,Nashville SC,24,1998,5.8,8,6,3,5,0,4,4,100.0,0,9,8,1,11,19,15,0,Matches
81,Tanner Beason,us USA,DF,SJ Earthquakes,25,1997,15.6,17,10,12,5,0,14,21,66.7,7,21,17,4,24,41,68,1,Matches
82,Gavin Beavers,us USA,GK,Real Salt Lake,17,2005,6.5,0,0,0,0,0,0,0,,0,0,0,0,0,0,5,1,Matches
83,Simon Becher,us USA,FWMF,Vancouver W'caps,23,1999,6.8,3,3,0,0,3,0,3,0.0,3,3,0,3,0,3,8,0,Matches
84,Alejandro Bedoya,us USA,MF,Philadelphia Union,35,1987,22.3,36,22,18,12,6,16,49,32.7,33,25,8,17,23,59,19,1,Matches
85,Steven Beitashour,ir IRN,DF,Colorado Rapids,35,1987,6.7,6,4,4,2,0,5,10,50.0,5,3,2,1,2,8,18,0,Matches
86,Jon Bell,jm JAM,DF,St. Louis,25,1997,1.6,2,1,1,1,0,1,3,33.3,2,3,2,1,2,4,5,0,Matches
87,Zaydan Bello,au AUS,MF,Minnesota Utd,20,2002,0.2,1,1,0,0,1,0,1,0.0,1,0,0,0,0,1,0,0,Matches
88,Nico Benalcázar,us USA,MF,NYCFC,21,2001,0.1,0,0,0,0,0,0,0,,0,1,1,0,1,1,0,0,Matches
89,Ben Bender,us USA,MFFW,Charlotte,21,2001,10.1,15,8,4,7,4,9,18,50.0,9,10,0,10,5,20,6,0,Matches
90,Joe Bendik,us USA,GK,Philadelphia Union,33,1989,7.6,0,0,0,0,0,0,0,,0,0,0,0,0,0,2,0,Matches
91,Christian Benteke,be BEL,FW,D.C. United,32,1990,31.0,15,6,0,8,7,3,12,25.0,9,15,3,12,4,19,30,0,Matches
92,Sebastian Berhalter,us USA,MF,Vancouver W'caps,21,2001,14.4,38,24,19,16,3,16,29,55.2,13,23,5,18,19,57,27,0,Matches
93,Federico Bernardeschi,it ITA,FWMF,Toronto FC,28,1994,28.9,16,11,4,6,6,7,25,28.0,18,16,0,16,12,28,2,2,Matches
94,Miguel Berry,es ESP,FW,Atlanta Utd,25,1997,11.5,9,5,6,2,1,4,8,50.0,4,4,0,4,2,11,4,0,Matches
95,Aaron Bibout,cm CMR,FW,LA Galaxy,18,2004,0.3,0,0,0,0,0,0,0,,0,0,0,0,0,0,0,0,Matches
96,David Bingham,us USA,GK,Portland Timbers,33,1989,19.0,0,0,0,0,0,0,1,0.0,1,1,0,1,3,3,13,1,Matches
97,Steve Birnbaum,us USA,DF,D.C. United,32,1991,17.9,16,9,10,4,2,7,11,63.6,4,15,9,6,23,39,75,0,Matches
98,Stipe Biuk,hr CRO,FW,LAFC,20,2002,14.9,13,8,7,3,3,6,27,22.2,21,14,1,13,8,21,9,0,Matches
99,Tristan Blackmon,us USA,DF,Vancouver W'caps,26,1996,28.0,17,10,12,4,1,11,19,57.9,8,24,17,7,34,51,116,1,Matches
100,Andre Blake,jm JAM,GK,Philadelphia Union,32,1990,26.4,0,0,0,0,0,0,0,,0,0,0,0,0,0,11,1,Matches
Rk
101,Sebastián Blanco,ar ARG,FWMF,Portland Timbers,34,1988,4.9,0,0,0,0,0,0,4,0.0,4,1,0,1,2,2,0,0,Matches
102,Latif Blessing,gh GHA,FWMF,Toronto FC,26,1996,1.7,2,1,1,1,0,1,1,100.0,0,2,0,2,0,2,0,0,Matches
103,Latif Blessing,gh GHA,MF,NE Revolution,26,1996,11.5,36,20,17,17,2,15,36,41.7,21,15,3,12,14,50,7,1,Matches
104,Njabulo Blom,za RSA,MF,St. Louis,23,1999,21.3,45,19,22,15,8,18,47,38.3,29,30,5,25,49,94,22,0,Matches
105,Emmanuel Boateng,gh GHA,FWMF,NE Revolution,29,1994,16.0,14,7,7,5,2,2,11,18.2,9,14,4,10,10,24,12,0,Matches
106,Israel Boatwright,do DOM,MFDF,Inter Miami,17,2005,0.8,1,0,1,0,0,1,3,33.3,2,1,1,0,0,1,4,0,Matches
107,Mateusz Bogusz,pl POL,MFFW,LAFC,21,2001,19.3,35,24,12,16,7,12,36,33.3,24,12,0,12,6,41,14,0,Matches
108,Franck Boli,ci CIV,FW,Portland Timbers,29,1993,16.2,11,5,1,5,5,1,7,14.3,6,6,0,6,0,11,3,0,Matches
109,Joshua Bolma,gh GHA,MF,NE Revolution,20,2002,0.3,2,2,1,1,0,1,1,100.0,0,0,0,0,0,2,0,0,Matches
110,Moïse Bombito,ca CAN,DF,Colorado Rapids,22,2000,8.3,19,10,13,5,1,16,17,94.1,1,9,2,7,11,30,38,0,Matches
111,Jonathan Bond,eng ENG,GK,LA Galaxy,29,1993,22.8,0,0,0,0,0,0,0,,0,1,0,1,2,2,17,5,Matches
112,Pablo Bonilla,ve VEN,DF,Portland Timbers,23,1999,0.8,2,2,0,1,1,2,4,50.0,2,2,1,1,0,2,2,0,Matches
113,Alex Bono,us USA,GK,D.C. United,28,1994,9.5,1,0,1,0,0,1,1,100.0,0,0,0,0,0,1,3,0,Matches
114,Shanyder Borgelin,ht HAI,FW,Inter Miami,21,2001,1.6,0,0,0,0,0,0,1,0.0,1,1,0,1,1,1,1,0,Matches
115,Dylan Borrero,co COL,FWMF,NE Revolution,21,2002,5.7,7,4,3,2,2,5,9,55.6,4,6,0,6,3,10,1,0,Matches
116,Gustavo Bou,ar ARG,FWMF,NE Revolution,32,1990,14.0,12,7,5,5,2,4,16,25.0,12,11,1,10,7,19,4,0,Matches
117,Denis Bouanga,ga GAB,FW,LAFC,28,1994,28.1,31,22,8,18,5,14,44,31.8,30,18,2,16,4,35,18,0,Matches
118,Ousseni Bouda,bf BFA,FWMF,SJ Earthquakes,22,2000,1.7,2,0,0,1,1,0,0,,0,2,1,1,2,4,0,0,Matches
119,Aaron Boupendza,ga GAB,FW,FC Cincinnati,26,1996,6.7,7,4,0,5,2,2,6,33.3,4,13,0,13,1,8,1,0,Matches
120,Michael Boxall,nz NZL,DF,Minnesota Utd,34,1988,31.7,42,24,28,11,3,17,24,70.8,7,53,31,22,48,90,138,2,Matches
121,Tyler Boyd,us USA,FWMF,LA Galaxy,28,1994,25.8,35,23,14,14,7,17,43,39.5,26,25,3,22,12,47,11,0,Matches
122,Michael Bradley,us USA,MFDF,Toronto FC,35,1987,16.0,20,17,14,6,0,14,23,60.9,9,12,3,9,19,39,53,1,Matches
123,Christopher Brady,us USA,GK,Chicago Fire,18,2004,29.3,0,0,0,0,0,0,2,0.0,2,0,0,0,1,1,20,3,Matches
124,Zachary Brault-Guillard,ca CAN,DFMF,CF Montréal,24,1998,14.5,15,9,10,2,3,8,20,40.0,12,20,5,15,12,27,21,0,Matches
125,Claudio Bravo,ar ARG,DF,Portland Timbers,25,1997,25.9,68,39,45,21,2,36,92,39.1,56,51,7,44,39,107,62,0,Matches
Rk
126,Luke Brennan,us USA,MF,Atlanta Utd,17,2005,0.0,0,0,0,0,0,0,0,,0,0,0,0,0,0,0,0,Matches
127,Brenner,br BRA,FW,FC Cincinnati,23,2000,5.9,6,5,3,2,1,4,9,44.4,5,6,0,6,2,8,2,0,Matches
128,Ethan Bristow,kn SKN,DF,Minnesota Utd,21,2001,6.0,11,7,8,3,0,6,10,60.0,4,5,3,2,2,13,15,1,Matches
129,Andrew Brody,us USA,DF,Real Salt Lake,27,1995,25.2,27,19,16,8,3,14,27,51.9,13,27,13,14,25,52,54,0,Matches
130,Brandt Bronico,us USA,MF,Charlotte,27,1995,28.8,48,30,18,22,8,27,65,41.5,38,32,9,23,23,71,36,0,Matches
131,Javain Brown,jm JAM,DF,Vancouver W'caps,23,1999,19.6,33,18,12,17,4,18,30,60.0,12,19,7,12,21,54,67,1,Matches
132,Gastón Brugman,uy URU,MF,LA Galaxy,30,1992,21.1,57,36,30,21,6,27,56,48.2,29,26,7,19,37,94,28,0,Matches
133,Will Bruin,us USA,FW,Austin,33,1989,3.9,0,0,0,0,0,0,4,0.0,4,0,0,0,0,0,8,0,Matches
134,Noel Buck,eng ENG,MFFW,NE Revolution,17,2005,19.5,53,32,20,26,7,30,61,49.2,31,26,4,22,18,71,16,0,Matches
135,Teal Bunbury,us USA,FW,Nashville SC,32,1990,18.3,8,8,1,3,4,1,9,11.1,8,9,2,7,7,15,8,0,Matches
136,Cory Burke,jm JAM,FW,NY Red Bulls,31,1991,10.8,26,18,4,14,8,7,21,33.3,14,11,1,10,4,30,5,0,Matches
137,Roman Bürki,ch SUI,GK,St. Louis,32,1990,33.0,1,1,1,0,0,1,3,33.3,2,0,0,0,0,1,17,2,Matches
138,Kendall Burks,us USA,DFMF,Chicago Fire,23,1999,5.7,8,5,7,1,0,3,6,50.0,3,10,7,3,6,14,26,0,Matches
139,Sergio Busquets,es ESP,MF,Inter Miami,34,1988,10.3,37,19,16,18,3,24,37,64.9,13,12,2,10,17,54,7,1,Matches
140,Brandon Bye,us USA,DF,NE Revolution,27,1995,18.5,27,18,13,11,3,14,21,66.7,7,20,9,11,20,47,59,0,Matches
141,Nathan Byrne,eng ENG,DF,Charlotte,30,1992,28.9,41,27,25,15,1,27,56,48.2,29,29,6,23,20,61,56,1,Matches
142,Jorge Cabezas,co COL,FWMF,NY Red Bulls,19,2003,1.3,2,1,1,1,0,1,3,33.3,2,2,0,2,0,2,0,0,Matches
143,Kevin Cabral,fr FRA,FWMF,Colorado Rapids,23,1999,13.1,21,11,5,12,4,4,10,40.0,6,11,1,10,9,30,6,0,Matches
144,Rémi Cabral,fr FRA,DF,Colorado Rapids,23,1999,0.1,1,0,0,0,1,0,1,0.0,1,0,0,0,0,1,0,0,Matches
145,Martín Cáceres,uy URU,DF,LA Galaxy,35,1987,14.5,5,3,5,0,0,2,10,20.0,8,13,9,4,10,15,48,1,Matches
146,Deiber Caicedo,co COL,MFFW,Vancouver W'caps,22,2000,2.2,4,3,1,1,2,2,2,100.0,0,2,0,2,3,7,1,0,Matches
147,Luís Caicedo,co COL,MF,Houston Dynamo,26,1996,13.5,20,13,12,7,1,11,26,42.3,15,19,6,13,17,37,24,0,Matches
148,Scott Caldwell,us USA,MF,Real Salt Lake,31,1991,1.9,1,1,0,1,0,1,3,33.3,2,0,0,0,0,1,2,0,Matches
149,Lucas Calegari,br BRA,DF,LA Galaxy,20,2002,21.5,42,29,27,10,5,24,41,58.5,17,26,10,16,23,65,35,1,Matches
150,Noel Caliskan,de GER,MF,Portland Timbers,22,2000,2.9,5,4,4,1,0,2,7,28.6,5,3,1,2,2,7,1,0,Matches
Rk
151,Drake Callender,us USA,GK,Inter Miami,25,1997,33.0,1,0,1,0,0,1,2,50.0,1,0,0,0,0,1,11,3,Matches
152,Rudy Camacho,fr FRA,DF,Columbus Crew,31,1991,8.8,10,6,6,3,1,4,6,66.7,2,9,1,8,8,18,41,1,Matches
153,Rudy Camacho,fr FRA,DFMF,CF Montréal,31,1991,17.9,19,14,14,4,1,9,14,64.3,5,19,13,6,29,48,77,2,Matches
154,Brandon Cambridge,us USA,FWDF,Charlotte,20,2002,1.5,0,0,0,0,0,0,1,0.0,1,1,0,1,1,1,3,0,Matches
155,Leonardo Campana,ec ECU,FW,Inter Miami,22,2000,18.2,19,13,4,9,6,9,18,50.0,9,19,7,12,4,23,13,0,Matches
156,George Campbell,us USA,DF,CF Montréal,21,2001,20.6,42,29,32,7,3,26,39,66.7,13,26,10,16,25,67,51,7,Matches
157,Russell Canouse,us USA,MF,D.C. United,27,1995,24.6,67,45,31,28,8,34,61,55.7,27,35,10,25,31,98,22,0,Matches
158,Antonio Carlos,br BRA,DF,Orlando City,29,1993,15.7,9,8,7,2,0,5,13,38.5,8,16,13,3,16,25,73,0,Matches
159,Wikelman Carmona,ve VEN,FWMF,NY Red Bulls,19,2003,7.4,8,6,3,2,3,3,15,20.0,12,2,0,2,3,11,3,0,Matches
160,Julián Carranza,ar ARG,FW,Philadelphia Union,22,2000,27.6,34,14,5,21,8,7,32,21.9,25,31,4,27,12,46,19,0,Matches
161,Adalberto Carrasquilla,pa PAN,FWMF,Houston Dynamo,24,1998,22.6,11,7,3,7,1,4,28,14.3,24,19,2,17,9,20,13,0,Matches
162,Wilder Cartagena,pe PER,MF,Orlando City,28,1994,21.1,57,30,20,31,6,24,58,41.4,34,31,7,24,11,68,25,0,Matches
163,Javier Casas,us USA,MF,Chicago Fire,19,2003,0.6,1,1,0,0,1,0,0,,0,0,0,0,1,2,1,0,Matches
164,Julio Cascante,cr CRC,DF,Austin,29,1993,22.9,20,14,14,6,0,15,27,55.6,12,18,14,4,20,40,94,1,Matches
165,Cristian Cásseres Jr.,ve VEN,MF,NY Red Bulls,23,2000,16.0,41,24,15,20,6,15,40,37.5,25,19,2,17,19,60,12,0,Matches
166,Robert Castellanos,us USA,DF,Sporting KC,24,1998,7.8,7,7,5,2,0,5,8,62.5,3,10,9,1,9,16,45,0,Matches
167,Roman Celentano,us USA,GK,FC Cincinnati,22,2000,33.0,0,0,0,0,0,0,0,,0,0,0,0,0,0,16,3,Matches
168,Edwin Cerrillo,us USA,MF,FC Dallas,22,2000,15.1,24,15,11,10,3,12,35,34.3,23,23,6,17,14,38,15,0,Matches
169,Edwin Cerrillo,us USA,MF,LA Galaxy,22,2000,9.0,10,9,6,4,0,8,15,53.3,7,8,1,7,6,16,6,1,Matches
170,Tomás Chancalay,ar ARG,FWMF,NE Revolution,24,1999,9.5,17,11,6,7,4,8,22,36.4,14,8,0,8,3,20,5,0,Matches
171,Maikel Chang,cu CUB,MFFW,Real Salt Lake,31,1991,11.3,16,8,6,6,4,8,19,42.1,11,13,0,13,5,21,10,0,Matches
172,Maxime Chanot,lu LUX,DF,NYCFC,33,1989,19.0,26,16,21,5,0,19,30,63.3,11,17,8,9,27,53,94,1,Matches
173,Diego Chará,co COL,MF,Portland Timbers,36,1986,28.5,65,40,37,25,3,26,58,44.8,32,24,9,15,30,95,32,1,Matches
174,Yimmi Chará,co COL,FW,Portland Timbers,31,1991,8.2,16,11,6,6,4,5,13,38.5,8,7,0,7,5,21,8,0,Matches
175,Yevhen Cheberko,ua UKR,DF,Columbus Crew,25,1998,2.2,4,3,3,1,0,1,3,33.3,2,0,0,0,2,6,12,1,Matches
Rk
176,Giorgio Chiellini,it ITA,DF,LAFC,38,1984,15.2,18,11,13,5,0,8,16,50.0,8,9,6,3,29,47,58,0,Matches
177,Mathieu Choiniere,ca CAN,MFDF,CF Montréal,23,1999,27.0,60,38,30,25,5,23,54,42.6,31,38,9,29,26,86,32,0,Matches
178,Léo Chú,br BRA,FW,Seattle Sounders,22,2000,22.8,33,20,11,14,8,6,30,20.0,24,10,0,10,11,44,6,0,Matches
179,José Cifuentes,ec ECU,MF,LAFC,23,1999,15.1,27,22,9,11,7,11,38,28.9,27,15,2,13,11,38,11,0,Matches
180,Cam Cilley,us USA,FWMF,SJ Earthquakes,22,2000,0.0,0,0,0,0,0,0,0,,0,0,0,0,0,0,0,0,Matches
181,Abdoulaye Cissoko,fr FRA,DF,Seattle Sounders,23,1999,1.0,1,0,0,0,1,0,0,,0,0,0,0,0,1,1,0,Matches
182,Steve Clark,us USA,GK,Houston Dynamo,36,1986,33.0,1,0,1,0,0,1,1,100.0,0,0,0,0,0,1,10,0,Matches
183,Stefan Cleveland,us USA,GK,Seattle Sounders,28,1994,2.0,0,0,0,0,0,0,0,,0,0,0,0,0,0,0,0,Matches
184,Noah Cobb,us USA,DF,Atlanta Utd,17,2005,2.2,2,1,1,1,0,1,2,50.0,1,2,1,1,0,2,9,0,Matches
185,Alonso Coello,es ESP,MF,Toronto FC,23,1999,14.3,59,40,38,16,5,29,57,50.9,28,15,1,14,18,77,14,0,Matches
186,Jackson Conway,us USA,FW,Atlanta Utd,21,2001,0.6,0,0,0,0,0,0,0,,0,0,0,0,0,0,0,0,Matches
187,Enzo Copetti,ar ARG,FW,Charlotte,27,1996,22.0,8,3,1,3,4,1,20,5.0,19,14,2,12,5,13,20,0,Matches
188,Gabriele Corbo,it ITA,DF,CF Montréal,23,2000,25.4,31,18,19,11,1,23,49,46.9,26,26,15,11,32,63,86,2,Matches
189,Sergio Córdova,ve VEN,FWMF,Vancouver W'caps,25,1997,9.4,13,11,3,9,1,4,7,57.1,3,6,1,5,1,14,11,0,Matches
190,Carlos Coronel,py PAR,GK,NY Red Bulls,26,1996,34.0,0,0,0,0,0,0,0,,0,0,0,0,0,0,21,5,Matches
191,Guzmán Corujo,uy URU,DF,Charlotte,26,1996,3.9,9,8,7,2,0,7,8,87.5,1,3,2,1,5,14,14,1,Matches
192,Douglas Costa,br BRA,FWMF,LA Galaxy,32,1990,13.5,9,6,3,4,2,4,18,22.2,14,13,0,13,8,17,5,0,Matches
193,Séga Coulibaly,fr FRA,DF,LA Galaxy,26,1996,1.0,3,2,2,1,0,2,4,50.0,2,0,0,0,0,3,2,0,Matches
194,Cade Cowell,us USA,FW,SJ Earthquakes,19,2003,17.1,15,9,5,6,4,9,20,45.0,11,20,2,18,6,21,6,0,Matches
195,Ben Cremaschi,us USA,MFFW,Inter Miami,17,2005,19.9,44,28,17,19,8,27,77,35.1,50,23,2,21,14,58,14,1,Matches
196,Maxime Crépeau,ca CAN,GK,LAFC,28,1994,7.0,0,0,0,0,0,0,0,,0,0,0,0,0,0,3,0,Matches
197,Daniel Crisostomo,us USA,MF,LAFC,26,1997,3.1,5,5,2,2,1,0,6,0.0,6,1,1,0,5,10,3,0,Matches
198,Andrés Cubas,py PAR,MF,Vancouver W'caps,26,1996,23.8,65,40,27,37,1,27,67,40.3,40,39,8,31,50,115,26,0,Matches
199,Cucho,co COL,FW,Columbus Crew,23,1999,26.3,24,11,6,10,8,11,28,39.3,17,20,1,19,10,34,7,0,Matches
200,Mauricio Cuevas,us USA,DF,LA Galaxy,19,2003,4.7,8,5,3,5,0,4,15,26.7,11,2,0,2,5,13,13,0,Matches
Rk
201,Braian Cufré,ar ARG,DF,NYCFC,26,1996,20.7,39,25,18,19,2,18,33,54.5,15,30,4,26,17,56,37,0,Matches
202,Antony Curic,ca CAN,DF,Toronto FC,22,2001,0.0,0,0,0,0,0,0,0,,0,0,0,0,0,0,0,0,Matches
203,Rafael Czichos,de GER,DF,Chicago Fire,32,1990,27.9,48,34,33,13,2,24,39,61.5,15,35,18,17,44,92,103,1,Matches
204,Cristián Dajome,co COL,FWDF,D.C. United,29,1994,8.7,14,10,6,7,1,4,19,21.1,15,5,1,4,4,18,5,0,Matches
205,Cristián Dajome,co COL,MFFW,Vancouver W'caps,29,1994,3.3,6,3,4,0,2,3,7,42.9,4,2,0,2,4,10,1,0,Matches
206,Dagur Dan Þórhallsson,is ISL,DFMF,Orlando City,22,2000,13.4,11,9,7,4,0,4,14,28.6,10,12,2,10,9,20,20,0,Matches
207,Daniel,br BRA,GK,SJ Earthquakes,28,1994,21.6,0,0,0,0,0,0,0,,0,0,0,0,0,0,10,0,Matches
208,Jesús Daniel Bueno,ve VEN,MF,Philadelphia Union,23,1999,10.7,37,21,12,23,2,18,37,48.6,19,17,1,16,17,54,17,1,Matches
209,Juan David Mosquera,co COL,DF,Portland Timbers,20,2002,26.7,38,27,20,9,9,14,39,35.9,25,17,1,16,18,56,35,0,Matches
210,Jesús David Murillo,co COL,DF,LAFC,28,1994,15.8,29,15,19,10,0,17,31,54.8,14,20,8,12,19,48,59,0,Matches
211,Bode Davis,us USA,DF,Real Salt Lake,20,2002,13.1,22,15,14,6,2,12,22,54.5,10,15,4,11,15,37,25,0,Matches
212,Erick Davis,pa PAN,DF,D.C. United,31,1991,6.0,8,5,3,5,0,6,11,54.5,5,10,2,8,9,17,12,0,Matches
213,Jake Davis,us USA,DF,Sporting KC,21,2002,22.6,67,40,32,29,6,35,79,44.3,44,27,8,19,34,101,53,0,Matches
214,Sean Davis,us USA,MF,Nashville SC,29,1993,20.8,27,13,7,13,7,17,40,42.5,23,34,15,19,30,57,29,0,Matches
215,Jonathan Dean,us USA,DF,Chicago Fire,25,1997,15.3,24,13,15,8,1,12,23,52.2,11,21,5,16,23,47,49,1,Matches
216,Miloš Degenek,au AUS,DF,Columbus Crew,28,1994,9.5,16,10,10,6,0,7,12,58.3,5,15,13,2,15,31,37,1,Matches
217,Brecht Dejaegere,be BEL,FWMF,Charlotte,31,1991,5.3,10,6,2,6,2,4,8,50.0,4,10,0,10,5,15,3,0,Matches
218,Marky Delgado,us USA,MF,LA Galaxy,27,1995,25.7,55,33,19,30,6,26,65,40.0,39,46,10,36,36,91,26,0,Matches
219,Luis Díaz,cr CRC,FW,Colorado Rapids,24,1998,1.0,2,1,2,0,0,1,2,50.0,1,0,0,0,0,2,0,0,Matches
220,Luis Díaz,cr CRC,DFMF,Columbus Crew,24,1998,0.9,1,1,0,1,0,0,0,,0,0,0,0,0,1,1,0,Matches
221,Bakaye Dibassy,ml MLI,DF,Minnesota Utd,33,1989,5.3,6,3,4,2,0,2,4,50.0,2,6,3,3,3,9,14,0,Matches
222,Adama Diomande,no NOR,FW,Toronto FC,32,1990,1.8,0,0,0,0,0,0,3,0.0,3,1,0,1,0,0,2,0,Matches
223,Clément Diop,sn SEN,GK,Atlanta Utd,29,1993,1.5,0,0,0,0,0,0,0,,0,0,0,0,0,0,0,0,Matches
224,Hamady Diop,sn SEN,DFMF,Charlotte,20,2002,0.4,1,1,1,0,0,0,1,0.0,1,1,0,1,0,1,5,0,Matches
225,Sofiane Djeffal,fr FRA,MF,Austin,23,1999,3.5,5,3,2,2,1,2,5,40.0,3,4,1,3,2,7,5,0,Matches
Rk
226,Ethan Dobbelaere,us USA,FW,Seattle Sounders,20,2002,1.1,0,0,0,0,0,0,3,0.0,3,0,0,0,0,0,0,0,Matches
227,Ronald Donkor,ml MLI,MFDF,NY Red Bulls,18,2004,0.5,3,2,0,3,0,0,0,,0,0,0,0,1,4,0,0,Matches
228,Christopher Donovan,us USA,FW,Philadelphia Union,22,2000,4.3,5,4,0,4,1,4,12,33.3,8,5,1,4,2,7,2,0,Matches
229,Griffin Dorsey,us USA,DF,Houston Dynamo,23,1999,11.4,14,10,8,4,2,4,8,50.0,4,13,3,10,13,27,34,0,Matches
230,C.J. dos Santos,us USA,GK,Inter Miami,22,2000,1.0,0,0,0,0,0,0,0,,0,0,0,0,0,0,1,0,Matches
231,Hassani Dotson,us USA,MFFW,Minnesota Utd,25,1997,28.6,65,34,21,33,11,27,47,57.4,20,48,9,39,32,97,50,0,Matches
232,Ousmane Doumbia,ci CIV,MF,Chicago Fire,30,1992,9.0,19,11,11,7,1,9,23,39.1,14,10,3,7,15,34,7,1,Matches
233,Sebastián Driussi,ar ARG,MFFW,Austin,26,1996,25.6,34,23,12,16,6,11,33,33.3,22,29,6,23,8,42,33,0,Matches
234,Erik Duenas,us USA,MFDF,LAFC,18,2004,8.4,29,14,10,15,4,19,40,47.5,21,13,1,12,13,42,6,0,Matches
235,Bryce Duke,us USA,MF,Inter Miami,21,2001,4.9,9,3,4,5,0,5,6,83.3,1,3,0,3,7,16,0,0,Matches
236,Bryce Duke,us USA,MFFW,CF Montréal,21,2001,16.3,24,13,6,14,4,14,24,58.3,10,13,0,13,15,39,2,0,Matches
237,Cameron Duke,us USA,DF,Sporting KC,21,2001,1.5,5,3,4,1,0,1,4,25.0,3,0,0,0,5,10,3,0,Matches
238,Cameron Dunbar,us USA,MFFW,Minnesota Utd,20,2002,1.3,2,0,1,1,0,1,3,33.3,2,0,0,0,2,4,2,0,Matches
239,Kyle Duncan,us USA,DF,NY Red Bulls,25,1997,20.5,54,38,21,19,14,37,54,68.5,17,37,4,33,30,84,32,0,Matches
240,Chris Durkin,us USA,MF,D.C. United,22,2000,21.9,46,34,16,22,8,25,47,53.2,22,26,7,19,21,67,27,1,Matches
241,Jeremy Ebobisse,us USA,FW,SJ Earthquakes,25,1997,32.9,16,9,3,9,4,6,25,24.0,19,10,3,7,14,30,13,0,Matches
242,Daniel Edelman,us USA,MF,NY Red Bulls,19,2003,20.6,46,24,11,27,8,27,59,45.8,32,32,2,30,27,73,22,0,Matches
243,Earl Edwards Jr.,us USA,GK,NE Revolution,31,1992,10.0,0,0,0,0,0,0,1,0.0,1,0,0,0,0,0,4,1,Matches
244,Raheem Edwards,ca CAN,DF,LA Galaxy,27,1995,20.8,58,33,32,18,8,33,63,52.4,30,31,5,26,24,82,45,1,Matches
245,Jack Elliott,eng ENG,DF,Philadelphia Union,27,1995,31.0,41,23,27,13,1,21,40,52.5,19,40,20,20,46,87,125,0,Matches
246,Herbert Endeley,us USA,MFFW,FC Dallas,21,2001,2.4,4,4,3,0,1,3,5,60.0,2,2,0,2,1,5,3,0,Matches
247,Emeka Eneli,us USA,DFMF,Real Salt Lake,23,1999,14.7,24,12,10,8,6,13,28,46.4,15,22,6,16,13,37,17,0,Matches
248,Ramiro Enrique,ar ARG,FW,Orlando City,21,2001,11.5,12,6,5,3,4,3,6,50.0,3,7,0,7,4,16,13,0,Matches
249,Franco Escobar,ar ARG,DF,Houston Dynamo,27,1995,24.7,72,49,43,22,7,42,62,67.7,20,31,8,23,35,107,37,0,Matches
250,Cristian Espinoza,ar ARG,FWMF,SJ Earthquakes,27,1995,33.7,47,33,22,11,14,22,84,26.2,62,37,2,35,21,68,23,0,Matches
Rk
251,Roger Espinoza,hn HON,MF,Sporting KC,36,1986,8.1,17,8,7,10,0,10,21,47.6,11,8,1,7,8,25,9,0,Matches
252,Derrick Etienne,ht HAI,FWMF,Atlanta Utd,26,1996,11.6,10,8,2,5,3,6,21,28.6,15,6,0,6,5,15,2,0,Matches
253,Evander,br BRA,MFFW,Portland Timbers,24,1998,24.5,22,11,9,8,5,14,53,26.4,39,20,2,18,14,36,5,0,Matches
254,Diego Fagúndez,uy URU,FWMF,Austin,27,1995,11.4,12,7,5,6,1,3,14,21.4,11,9,0,9,3,15,11,0,Matches
255,Diego Fagúndez,uy URU,FWMF,LA Galaxy,27,1995,6.4,12,7,5,4,3,5,9,55.6,4,8,3,5,1,13,5,0,Matches
256,José Fajardo,pa PAN,FWMF,D.C. United,29,1993,2.7,4,1,2,2,0,0,1,0.0,1,1,0,1,0,4,0,0,Matches
257,Mamadou Fall,sn SEN,DF,LAFC,20,2002,1.0,1,0,1,0,0,0,2,0.0,2,0,0,0,2,3,3,0,Matches
258,Marco Farfan,us USA,DF,FC Dallas,24,1998,29.8,48,26,34,10,4,33,60,55.0,27,33,12,21,29,77,54,0,Matches
259,Jordan Faria,ca CAN,FW,Toronto FC,22,2000,0.3,0,0,0,0,0,0,0,,0,0,0,0,0,0,0,0,Matches
260,Facundo Farías,ar ARG,FWMF,Inter Miami,20,2002,9.3,5,4,1,2,2,3,7,42.9,4,3,0,3,0,5,0,0,Matches
261,Andrew Farrell,us USA,DF,NE Revolution,30,1992,21.5,28,18,20,8,0,17,35,48.6,18,32,23,9,24,52,67,1,Matches
262,Mohamed Farsi,dz ALG,DFMF,Columbus Crew,23,1999,24.0,30,21,17,7,6,16,25,64.0,9,31,5,26,16,46,32,0,Matches
263,Felipe,br BRA,MF,Orlando City,32,1990,6.3,9,6,1,8,0,4,14,28.6,10,3,2,1,8,17,7,0,Matches
264,Julián Fernández,ar ARG,FWMF,NYCFC,19,2004,3.6,7,5,2,5,0,6,12,50.0,6,10,0,10,2,9,0,0,Matches
265,Omir Fernandez,us USA,MFFW,NY Red Bulls,23,1999,19.4,30,17,11,10,9,16,37,43.2,21,23,2,21,8,38,9,0,Matches
266,Jesús Ferreira,us USA,FW,FC Dallas,22,2000,25.2,30,14,13,10,7,11,30,36.7,19,6,0,6,14,44,16,0,Matches
267,Sebastián Ferreira,py PAR,FW,Houston Dynamo,24,1998,3.4,5,2,1,3,1,3,7,42.9,4,1,0,1,0,5,0,0,Matches
268,Ethan Finlay,us USA,FWMF,Austin,32,1990,18.8,26,14,13,10,3,11,26,42.3,15,22,2,20,7,33,12,0,Matches
269,Nicolas Firmino,us USA,MF,Atlanta Utd,22,2001,0.0,1,1,0,1,0,0,0,,0,0,0,0,0,1,0,0,Matches
270,Leon Flach,us USA,MF,Philadelphia Union,21,2001,19.9,35,19,12,19,4,15,39,38.5,24,28,6,22,32,67,22,0,Matches
271,Kristian Fletcher,us USA,FWMF,D.C. United,17,2005,1.5,2,2,0,2,0,1,5,20.0,4,0,0,0,0,2,0,0,Matches
272,Danny Flores,us USA,MF,Sporting KC,20,2002,0.1,0,0,0,0,0,0,0,,0,0,0,0,0,0,0,0,Matches
273,CJ Fodrey,us USA,DFFW,Austin,18,2004,0.4,0,0,0,0,0,0,0,,0,1,0,1,0,0,0,0,Matches
274,Nathan Fogaça,br BRA,FW,Portland Timbers,23,1999,6.3,4,4,2,1,1,0,7,0.0,7,5,0,5,1,5,3,0,Matches
275,Andreu Fontàs,es ESP,DF,Sporting KC,33,1989,26.6,55,35,31,20,4,30,56,53.6,26,32,16,16,40,95,76,1,Matches
Rk
276,Ajani Fortune,tt TRI,MF,Atlanta Utd,20,2002,4.2,8,2,2,5,1,3,7,42.9,4,3,2,1,4,12,5,1,Matches
277,Taxiarchis Fountas,gr GRE,FWMF,D.C. United,27,1995,12.2,15,7,3,9,3,6,22,27.3,16,16,1,15,5,20,1,0,Matches
278,Franco Fragapane,ar ARG,MFFW,Minnesota Utd,29,1993,14.8,21,12,10,7,4,13,27,48.1,14,13,0,13,11,32,3,0,Matches
279,Iván Franco,py PAR,FWMF,Houston Dynamo,22,2000,11.8,20,11,9,6,5,7,31,22.6,24,17,1,16,5,25,7,0,Matches
280,Kobe Franklin,ca CAN,DFMF,Toronto FC,19,2003,24.1,55,32,30,19,6,37,61,60.7,24,29,9,20,31,86,67,1,Matches
281,Liam Fraser,ca CAN,MF,FC Dallas,24,1998,4.1,6,5,1,2,3,4,7,57.1,3,6,3,3,6,12,4,0,Matches
282,Ian Fray,us USA,DFMF,Inter Miami,20,2002,7.3,18,9,10,7,1,12,19,63.2,7,11,4,7,9,27,16,1,Matches
283,Alexander Freeman,us USA,DF,Orlando City,18,2004,0.0,0,0,0,0,0,0,0,,0,0,0,0,0,0,0,0,Matches
284,Matt Freese,us USA,GK,NYCFC,24,1998,10.0,0,0,0,0,0,0,0,,0,0,0,0,0,0,1,0,Matches
285,Stefan Frei,ch SUI,GK,Seattle Sounders,36,1986,32.0,0,0,0,0,0,0,0,,0,0,0,0,0,0,10,2,Matches
286,Ray Gaddis,us USA,DF,FC Cincinnati,33,1990,13.9,25,17,13,8,4,15,21,71.4,6,23,4,19,13,38,19,2,Matches
287,Julian Gaines,us USA,DF,LAFC,20,2002,0.7,2,0,1,1,0,2,4,50.0,2,1,0,1,0,2,1,0,Matches
288,McKinze Gaines,us USA,FWMF,Charlotte,24,1998,8.2,8,5,4,1,3,1,9,11.1,8,4,1,3,2,10,2,0,Matches
289,Jon Gallagher,ie IRL,DFMF,Austin,26,1996,31.0,40,24,18,14,8,21,42,50.0,21,27,6,21,22,62,45,1,Matches
290,Pedro Gallese,pe PER,GK,Orlando City,32,1990,30.0,1,1,1,0,0,0,0,,0,1,0,1,0,1,10,1,Matches
291,Braian Galván,ar ARG,FWDF,Colorado Rapids,22,2000,7.4,6,2,2,3,1,4,8,50.0,4,5,1,4,8,14,3,0,Matches
292,Mender García,co COL,FWMF,Minnesota Utd,24,1998,11.4,12,7,4,4,4,4,12,33.3,8,12,0,12,4,16,1,0,Matches
293,Chase Gasper,us USA,DF,Houston Dynamo,27,1996,2.3,2,1,1,0,1,2,5,40.0,3,2,0,2,1,3,8,0,Matches
294,Ryan Gauld,sct SCO,FWMF,Vancouver W'caps,27,1995,29.2,64,39,15,30,19,16,46,34.8,30,37,2,35,16,80,15,0,Matches
295,Luka Gavran,ca CAN,GK,Toronto FC,22,2000,4.0,0,0,0,0,0,0,0,,0,0,0,0,0,0,2,0,Matches
296,Dániel Gazdag,hu HUN,MF,Philadelphia Union,26,1996,30.3,30,13,10,15,5,16,45,35.6,29,17,2,15,9,39,7,0,Matches
297,Geovane,br BRA,DF,FC Dallas,21,2001,11.0,15,10,8,5,2,11,20,55.0,9,15,6,9,15,30,42,0,Matches
298,Alex Gersbach,au AUS,DFMF,Colorado Rapids,25,1997,2.9,5,2,1,2,2,3,5,60.0,2,6,1,5,6,11,10,0,Matches
299,Giorgos Giakoumakis,gr GRE,FW,Atlanta Utd,28,1994,19.8,23,16,5,9,9,10,30,33.3,20,20,4,16,2,25,34,0,Matches
300,Carles Gil,es ESP,MF,NE Revolution,30,1992,29.1,22,19,8,11,3,12,36,33.3,24,12,1,11,14,36,5,0,Matches
Rk
301,Nacho Gil,es ESP,FWDF,NE Revolution,27,1995,5.8,10,7,1,7,2,2,7,28.6,5,3,1,2,4,14,3,0,Matches
302,Gastón Giménez,py PAR,MF,Chicago Fire,31,1991,24.4,57,40,18,32,7,29,51,56.9,22,46,17,29,28,85,25,1,Matches
303,Nicholas Gioacchini,us USA,FWMF,St. Louis,22,2000,23.3,24,15,7,11,6,5,15,33.3,10,28,4,24,10,34,14,0,Matches
304,Justen Glad,us USA,DF,Real Salt Lake,25,1997,30.2,39,25,25,13,1,22,35,62.9,13,37,26,11,50,89,120,1,Matches
305,Jakob Glesnes,no NOR,DF,Philadelphia Union,28,1994,31.0,48,27,28,15,5,23,48,47.9,25,44,26,18,46,94,90,1,Matches
306,Caden Glover,us USA,MF,St. Louis,15,2007,0.2,0,0,0,0,0,0,0,,0,1,0,1,0,0,0,0,Matches
307,Aníbal Godoy,pa PAN,MF,Nashville SC,32,1990,18.5,31,16,10,15,6,11,18,61.1,7,19,5,14,20,51,15,0,Matches
308,Yeimar Gómez Andrade,co COL,DF,Seattle Sounders,30,1992,32.1,48,30,34,14,0,23,46,50.0,23,31,19,12,73,121,143,0,Matches
309,Carlos Gómez,co COL,MFFW,Real Salt Lake,20,2002,15.5,27,22,12,9,6,10,32,31.3,22,22,2,20,8,35,3,0,Matches
310,Diego Gómez,py PAR,MFFW,Inter Miami,19,2003,4.6,13,6,4,5,4,7,14,50.0,7,7,1,6,5,18,1,0,Matches
311,Gaston Gonzalez,ar ARG,FWDF,Orlando City,21,2001,8.0,13,9,8,3,2,8,15,53.3,7,8,2,6,5,18,10,0,Matches
312,Mario González,es ESP,FW,LAFC,26,1996,4.3,1,0,0,0,1,0,0,,0,2,0,2,0,1,3,0,Matches
313,Omar Gonzalez,us USA,DF,NE Revolution,34,1988,9.6,6,4,2,3,1,2,6,33.3,4,14,11,3,5,11,53,0,Matches
314,Zavier Gozo,us USA,FW,Real Salt Lake,15,2007,0.1,0,0,0,0,0,0,0,,0,0,0,0,0,0,0,0,Matches
315,Alejandro Granados,es ESP,FW,Orlando City,16,2006,0.0,0,0,0,0,0,0,0,,0,0,0,0,0,0,0,0,Matches
316,Tayvon Gray,jm JAM,DF,NYCFC,20,2002,22.7,39,21,22,11,6,20,28,71.4,8,24,8,16,27,66,74,0,Matches
317,Jacob Greene,us USA,DF,D.C. United,19,2003,5.4,13,7,11,1,1,11,17,64.7,6,8,4,4,2,15,18,0,Matches
318,Gregore,br BRA,MF,Inter Miami,28,1994,4.3,7,5,3,2,2,6,12,50.0,6,7,1,6,3,10,5,0,Matches
319,Ján Greguš,sk SVK,MF,Nashville SC,32,1991,2.5,15,9,10,5,0,7,13,53.8,6,2,0,2,4,19,1,0,Matches
320,Ján Greguš,sk SVK,MF,Minnesota Utd,32,1991,10.0,10,7,1,9,0,5,10,50.0,5,3,0,3,8,18,10,0,Matches
321,Julian Gressel,us USA,DFMF,Columbus Crew,29,1993,8.2,17,11,5,8,4,11,20,55.0,9,9,1,8,6,23,8,0,Matches
322,Julian Gressel,us USA,MF,Vancouver W'caps,29,1993,15.1,23,10,8,13,2,15,33,45.5,18,15,3,12,14,37,12,0,Matches
323,Victor Griffith,pa PAN,MF,Portland Timbers,22,2000,1.0,0,0,0,0,0,0,0,,0,2,0,2,0,0,3,0,Matches
324,Carlos Gruezo,ec ECU,MF,SJ Earthquakes,27,1995,23.9,40,25,13,21,6,21,49,42.9,28,31,9,22,25,65,31,0,Matches
325,Brian Gutiérrez,us USA,FWMF,Chicago Fire,19,2003,26.5,45,22,18,22,5,14,49,28.6,35,29,3,26,8,53,11,1,Matches
Rk
326,Cristián Gutiérrez,cl CHI,DF,Toronto FC,25,1997,2.7,2,0,1,1,0,2,4,50.0,2,4,0,4,5,7,2,0,Matches
327,Diego Gutierrez,us USA,FWMF,Portland Timbers,23,1999,2.7,2,1,2,0,0,1,3,33.3,2,0,0,0,3,5,2,0,Matches
328,Felipe Gutiérrez,cl CHI,MF,Sporting KC,32,1990,3.3,8,5,2,6,0,2,6,33.3,4,1,0,1,3,11,3,0,Matches
329,Andrew Gutman,us USA,DF,Atlanta Utd,26,1996,15.4,31,18,17,11,3,20,34,58.8,14,20,9,11,13,44,30,0,Matches
330,Andrew Gutman,us USA,DF,Colorado Rapids,26,1996,11.2,21,15,12,8,1,16,27,59.3,11,13,3,10,15,36,31,0,Matches
331,Brad Guzan,us USA,GK,Atlanta Utd,38,1984,27.0,0,0,0,0,0,0,1,0.0,1,0,0,0,0,0,5,2,Matches
332,Justin Haak,us USA,DFMF,NYCFC,21,2001,10.1,11,8,7,4,0,7,12,58.3,5,9,4,5,20,31,36,2,Matches
333,Luke Haakenson,us USA,MFFW,Nashville SC,25,1997,3.0,5,2,2,2,1,2,7,28.6,5,2,1,1,2,7,2,0,Matches
334,Teenage Hadebe,zw ZIM,DF,Houston Dynamo,27,1995,11.5,9,5,7,2,0,4,14,28.6,10,22,19,3,13,22,57,1,Matches
335,Nick Hagglund,us USA,DF,FC Cincinnati,30,1992,23.9,28,18,16,10,2,14,24,58.3,10,24,12,12,32,60,114,0,Matches
336,Maren Haile-Selassie,ch SUI,FWDF,Chicago Fire,23,1999,21.2,29,19,7,15,7,12,23,52.2,11,13,1,12,18,47,15,0,Matches
337,Julian Hall,us USA,FW,NY Red Bulls,14,2008,0.1,0,0,0,0,0,0,0,,0,0,0,0,0,0,0,0,Matches
338,Michael Halliday,us USA,DF,Orlando City,20,2003,9.5,20,10,15,4,1,12,20,60.0,8,17,3,14,9,29,33,0,Matches
339,Bret Halsey,us USA,DF,FC Cincinnati,22,2000,2.6,6,5,4,1,1,4,9,44.4,5,3,1,2,1,7,4,0,Matches
340,Ahmed Hamdi,eg EGY,MFFW,CF Montréal,24,1998,5.3,16,5,7,7,2,3,11,27.3,8,7,0,7,1,17,4,0,Matches
341,Yosuke Hanya,jp JPN,FWMF,Colorado Rapids,24,1999,0.5,0,0,0,0,0,0,0,,0,0,0,0,0,0,0,0,Matches
342,Ian Harkes,us USA,MF,NE Revolution,27,1995,6.7,12,2,8,4,0,4,10,40.0,6,5,0,5,9,21,4,0,Matches
343,Cameron Harper,us USA,DFMF,NY Red Bulls,21,2001,23.9,40,30,14,17,9,25,63,39.7,38,37,3,34,11,51,27,1,Matches
344,Nathan Harriel,us USA,DF,Philadelphia Union,21,2001,18.6,42,34,20,14,8,23,39,59.0,16,33,5,28,44,86,49,1,Matches
345,Calvin Harris,eng ENG,FW,Colorado Rapids,22,2000,10.0,12,6,2,9,1,6,8,75.0,2,7,1,6,5,17,9,0,Matches
346,Thomas Hasal,ca CAN,GK,Vancouver W'caps,23,1999,1.0,0,0,0,0,0,0,0,,0,0,0,0,0,0,0,0,Matches
347,Héber,br BRA,FWMF,Seattle Sounders,31,1991,11.8,6,6,0,4,2,2,12,16.7,10,8,0,8,0,6,2,0,Matches
348,Matt Hedges,us USA,DF,Toronto FC,32,1990,11.9,18,11,14,3,1,10,17,58.8,7,13,7,6,18,36,57,0,Matches
349,Matt Hedges,us USA,DF,Austin,32,1990,3.4,2,1,1,1,0,0,2,0.0,2,4,3,1,3,5,14,0,Matches
350,Chris Hegardt,us USA,FWMF,Charlotte,21,2002,0.6,2,1,0,2,0,0,0,,0,0,0,0,0,2,0,0,Matches
Rk
351,Fabian Herbers,de GER,MFFW,Chicago Fire,29,1993,21.9,42,31,15,24,3,18,39,46.2,21,24,6,18,18,60,20,0,Matches
352,Felipe Hernandez,us USA,MF,Sporting KC,24,1998,3.6,11,6,2,8,1,7,14,50.0,7,5,0,5,4,15,1,0,Matches
353,Javier Hernández,mx MEX,FW,LA Galaxy,34,1988,7.6,2,1,0,1,1,1,3,33.3,2,1,0,1,4,6,2,0,Matches
354,Ronald Hernández,ve VEN,DF,Atlanta Utd,25,1997,7.8,14,8,7,7,0,10,19,52.6,9,7,2,5,9,23,13,0,Matches
355,Aaron Herrera,gt GUA,DFMF,CF Montréal,25,1997,15.6,30,21,14,11,5,7,19,36.8,12,20,5,15,14,44,31,0,Matches
356,Héctor Herrera,mx MEX,MF,Houston Dynamo,32,1990,28.1,55,37,20,26,9,20,52,38.5,32,48,12,36,19,74,16,0,Matches
357,Kyle Hiebert,ca CAN,DF,St. Louis,25,1997,23.6,45,24,22,18,5,27,43,62.8,16,41,13,28,29,74,95,0,Matches
358,Brendan Hines-Ike,us USA,DF,D.C. United,28,1994,10.4,12,9,9,3,0,5,10,50.0,5,14,11,3,11,23,46,1,Matches
359,Bongokuhle Hlongwane,za RSA,FW,Minnesota Utd,22,2000,27.6,48,35,18,21,9,17,40,42.5,23,54,5,49,26,74,26,0,Matches
360,Junior Hoilett,ca CAN,FWMF,Vancouver W'caps,32,1990,2.6,3,2,0,1,2,2,4,50.0,2,2,0,2,3,6,0,0,Matches
361,Ryan Hollingshead,us USA,DF,LAFC,31,1991,26.1,73,51,38,23,12,41,72,56.9,31,36,8,28,43,116,53,0,Matches
362,Erik Holt,us USA,DF,Real Salt Lake,26,1996,0.6,1,1,1,0,0,0,1,0.0,1,0,0,0,2,3,3,0,Matches
363,Jackson Hopkins,us USA,MF,D.C. United,18,2004,2.2,2,1,1,0,1,1,3,33.3,2,0,0,0,2,4,2,0,Matches
364,Matthew Hoppe,us USA,FWMF,SJ Earthquakes,21,2001,4.7,7,5,4,1,2,3,10,30.0,7,3,0,3,1,8,1,0,Matches
365,Keegan Hughes,us USA,DF,Columbus Crew,22,2000,0.0,0,0,0,0,0,0,0,,0,0,0,0,0,0,0,0,Matches
366,Erik Hurtado,us USA,FWMF,D.C. United,32,1990,3.0,1,1,0,0,1,1,2,50.0,1,2,0,2,0,1,1,0,Matches
367,Franco Ibarra,ar ARG,MF,Toronto FC,21,2001,4.9,11,7,4,7,0,4,15,26.7,11,7,3,4,8,19,9,0,Matches
368,Franco Ibarra,ar ARG,MF,Atlanta Utd,21,2001,14.2,61,33,25,31,5,33,62,53.2,29,31,1,30,14,75,31,1,Matches
369,Sebastien Ibeagha,us USA,DF,FC Dallas,31,1992,26.5,17,9,13,4,0,7,18,38.9,11,31,21,10,28,45,149,0,Matches
370,Aliyu Ibrahim,ng NGA,FW,Houston Dynamo,21,2002,13.4,16,11,2,9,5,6,14,42.9,8,9,0,9,1,17,4,0,Matches
371,Sunusi Ibrahim,ng NGA,FWMF,CF Montréal,20,2002,13.0,7,2,1,5,1,1,4,25.0,3,3,0,3,2,9,1,0,Matches
372,Tega Ikoba,us USA,FW,Portland Timbers,19,2003,1.0,1,1,0,1,0,1,1,100.0,0,1,0,1,0,1,0,0,Matches
373,Mitja Ilenič,si SVN,DF,NYCFC,18,2004,13.2,26,16,10,12,4,19,32,59.4,13,18,3,15,7,33,26,0,Matches
374,Ilias Iliadis,gr GRE,DFMF,CF Montréal,21,2001,2.8,5,3,2,2,1,3,4,75.0,1,0,0,0,5,10,4,0,Matches
375,Marko Ilić,rs SRB,GK,Colorado Rapids,24,1998,13.0,1,0,1,0,0,1,2,50.0,1,0,0,0,0,1,9,1,Matches
Rk
376,Asier Illarramendi,es ESP,MF,FC Dallas,32,1990,7.7,17,10,11,6,0,8,20,40.0,12,15,3,12,18,35,9,0,Matches
377,Lorenzo Insigne,it ITA,FWMF,Toronto FC,31,1991,16.9,10,7,5,3,2,3,21,14.3,18,7,0,7,13,23,1,0,Matches
378,Clint Irwin,us USA,GK,Minnesota Utd,33,1989,4.0,0,0,0,0,0,0,0,,0,0,0,0,0,0,4,0,Matches
379,Aljaž Ivačič,si SVN,GK,Portland Timbers,29,1993,15.0,0,0,0,0,0,0,2,0.0,2,0,0,0,0,0,9,1,Matches
380,Emmanuel Iwe,us USA,FW,Minnesota Utd,22,2000,0.6,0,0,0,0,0,0,1,0.0,1,0,0,0,0,0,0,0,Matches
381,Ousman jabang,us USA,DF,CF Montréal,21,2001,0.9,3,0,3,0,0,3,4,75.0,1,2,2,0,2,5,3,1,Matches
382,Aziel Jackson,us USA,MFFW,St. Louis,21,2001,12.4,27,15,9,13,5,14,36,38.9,22,17,2,15,5,32,3,0,Matches
383,Jacob Jackson,us USA,GK,NE Revolution,22,2000,2.0,0,0,0,0,0,0,0,,0,0,0,0,0,0,0,0,Matches
384,Bertin Jacquesson,fr FRA,FWMF,Real Salt Lake,22,2001,4.0,2,1,0,0,2,2,3,66.7,1,0,0,0,0,2,0,0,Matches
385,Eldin Jakupović,ch SUI,GK,LAFC,38,1984,2.0,0,0,0,0,0,0,0,,0,0,0,0,0,0,0,0,Matches
386,Robin Jansson,se SWE,DF,Orlando City,31,1991,32.0,24,12,16,6,2,20,29,69.0,9,42,31,11,23,47,92,0,Matches
387,Andres Jasson,us USA,FW,NYCFC,21,2002,9.0,13,10,4,4,5,7,17,41.2,10,16,0,16,3,16,2,0,Matches
388,Mohanad Jeahze,iq IRQ,DF,D.C. United,25,1997,4.0,9,5,3,6,0,7,13,53.8,6,0,0,0,4,13,2,0,Matches
389,Corentin Jean,fr FRA,FWMF,Inter Miami,27,1995,9.2,18,12,6,9,3,11,17,64.7,6,4,1,3,3,21,7,0,Matches
390,Isak Jensen,dk DEN,MFFW,St. Louis,19,2003,1.6,4,3,1,2,1,3,9,33.3,6,5,0,5,1,5,2,0,Matches
391,Hector Jiménez,us USA,MF,Austin,34,1988,0.6,0,0,0,0,0,0,1,0.0,1,0,0,0,1,1,0,0,Matches
392,Jesús Jiménez,es ESP,FWMF,FC Dallas,29,1993,7.6,8,4,0,5,3,4,7,57.1,3,7,0,7,2,10,1,1,Matches
393,Stiven Jimenez,us USA,FW,FC Cincinnati,15,2007,0.0,0,0,0,0,0,0,0,,0,0,0,0,0,0,0,0,Matches
394,Levonte Johnson,ca CAN,FWDF,Vancouver W'caps,23,1999,2.2,4,3,4,0,0,0,3,0.0,3,2,0,2,1,5,2,0,Matches
395,Sean Johnson,us USA,GK,Toronto FC,33,1989,20.0,0,0,0,0,0,0,0,,0,1,0,1,0,0,8,2,Matches
396,DeJuan Jones,us USA,DF,NE Revolution,25,1997,24.1,40,23,18,18,4,20,46,43.5,26,40,11,29,31,71,63,0,Matches
397,Derrick Jones,us USA,MFDF,Charlotte,25,1997,20.5,33,24,18,13,2,12,29,41.4,17,18,7,11,27,60,31,0,Matches
398,Juan José Sánchez,co COL,DF,Atlanta Utd,25,1998,23.7,33,14,20,13,0,16,25,64.0,9,24,17,7,37,70,98,0,Matches
399,Dejan Joveljić,rs SRB,FW,LA Galaxy,23,1999,18.1,8,6,0,2,6,1,12,8.3,11,9,3,6,3,11,5,0,Matches
400,Kamil Jóźwiak,pl POL,FWMF,Charlotte,24,1998,15.3,38,25,12,23,3,20,53,37.7,33,23,1,22,8,46,15,0,Matches
Rk
401,Preston Judd,us USA,FW,LA Galaxy,23,1999,7.1,2,1,0,1,1,1,4,25.0,3,3,1,2,1,3,5,0,Matches
402,Judson,br BRA,MF,SJ Earthquakes,29,1993,5.2,21,16,12,9,0,9,25,36.0,16,6,2,4,11,32,6,0,Matches
403,Anderson Julio,ec ECU,FW,Real Salt Lake,26,1996,12.8,8,6,2,4,2,3,13,23.1,10,13,1,12,2,10,10,0,Matches
404,Juninho,br BRA,MF,Orlando City,22,2001,0.0,0,0,0,0,0,0,0,,0,0,0,0,0,0,0,0,Matches
405,Sam Junqua,us USA,DFMF,FC Dallas,26,1996,11.4,17,12,8,7,2,11,20,55.0,9,20,4,16,11,28,23,0,Matches
406,Kristijan Kahlina,hr CRO,GK,Charlotte,30,1992,24.0,2,1,2,0,0,2,4,50.0,2,0,0,0,0,2,16,1,Matches
407,Brent Kallman,us USA,DFFW,Minnesota Utd,32,1990,2.2,3,2,3,0,0,2,6,33.3,4,4,1,3,0,3,11,0,Matches
408,Kei Kamara,sl SLE,FW,Chicago Fire,38,1984,16.9,6,1,0,3,3,2,9,22.2,7,14,4,10,4,10,29,0,Matches
409,Bernard Kamungo,us USA,FWMF,FC Dallas,21,2002,5.6,11,5,4,4,3,4,9,44.4,5,3,0,3,3,14,5,0,Matches
410,Alec Kann,us USA,GK,FC Cincinnati,32,1990,1.0,0,0,0,0,0,0,0,,0,0,0,0,0,0,0,0,Matches
411,Ercan Kara,at AUT,FW,Orlando City,27,1996,9.4,3,2,1,0,2,1,8,12.5,7,3,2,1,2,5,10,0,Matches
412,Ibrahim Kasule,ug UGA,MF,NY Red Bulls,18,2004,0.3,0,0,0,0,0,0,1,0.0,1,2,1,1,0,0,1,0,Matches
413,Mark-Anthony Kaye,ca CAN,MF,Toronto FC,28,1994,20.4,66,54,34,28,4,36,67,53.7,31,21,6,15,28,94,33,1,Matches
414,Mark-Anthony Kaye,ca CAN,MF,NE Revolution,28,1994,8.7,30,16,12,13,5,11,29,37.9,18,13,2,11,11,41,18,0,Matches
415,Axel Kei,us USA,FW,Real Salt Lake,15,2007,0.1,0,0,0,0,0,0,0,,0,0,0,0,0,0,0,0,Matches
416,Kipp Keller,us USA,DF,Austin,22,2000,4.9,1,1,1,0,0,0,3,0.0,3,4,3,1,0,1,19,1,Matches
417,Deandre Kerr,ca CAN,FWMF,Toronto FC,20,2002,13.5,11,8,3,7,1,5,12,41.7,7,8,1,7,4,15,4,0,Matches
418,Henry Kessler,us USA,DF,NE Revolution,24,1998,7.7,15,13,9,6,0,6,7,85.7,1,19,12,7,5,20,26,0,Matches
419,Benjamin Kikanovic,us USA,FWMF,SJ Earthquakes,23,2000,7.8,9,5,5,0,4,3,11,27.3,8,9,0,9,8,17,9,0,Matches
420,Gadi Kinda,il ISR,MF,Sporting KC,28,1994,9.3,21,11,11,6,4,11,21,52.4,10,8,0,8,4,25,6,0,Matches
421,Sota Kitahara,us USA,DF,Seattle Sounders,20,2003,0.0,0,0,0,0,0,0,0,,0,0,0,0,0,0,0,0,Matches
422,Klauss,br BRA,FW,St. Louis,25,1997,14.6,15,7,3,8,4,4,20,20.0,16,9,2,7,7,22,20,0,Matches
423,John Klein,us USA,MF,St. Louis,23,1999,0.3,2,2,0,1,1,1,1,100.0,0,1,0,1,1,3,0,0,Matches
424,Mateusz Klich,pl POL,MFFW,D.C. United,32,1990,30.2,48,36,14,24,10,21,59,35.6,38,34,4,30,14,62,11,1,Matches
425,Jonathan Klinsmann,us USA,GK,LA Galaxy,25,1997,9.2,0,0,0,0,0,0,0,,0,0,0,0,0,0,7,1,Matches
Rk
426,Žan Kolmanič,si SVN,DF,Austin,22,2000,4.7,14,11,7,7,0,7,10,70.0,3,4,1,3,6,20,15,0,Matches
427,Amet Korca,us USA,DF,FC Dallas,22,2000,1.7,1,0,1,0,0,1,1,100.0,0,3,3,0,4,5,1,1,Matches
428,Georgios Koutsias,gr GRE,FWMF,Chicago Fire,18,2004,11.3,4,2,2,1,1,2,16,12.5,14,8,4,4,3,7,13,0,Matches
429,Sebastian Kowalczyk,pl POL,FWMF,Houston Dynamo,24,1998,3.9,2,2,0,2,0,0,1,0.0,1,3,0,3,2,4,1,1,Matches
430,Filip Krastev,bg BUL,MF,LAFC,21,2001,1.8,6,3,3,2,1,1,7,14.3,6,8,0,8,1,7,1,0,Matches
431,Damir Kreilach,hr CRO,FWMF,Real Salt Lake,33,1989,14.6,2,1,1,0,1,1,9,11.1,8,4,1,3,2,4,15,0,Matches
432,Serhiy Kryvtsov,ua UKR,DF,Inter Miami,31,1991,23.5,19,11,11,7,1,6,13,46.2,7,30,18,12,31,50,81,0,Matches
433,Theodore Ku-Dipietro,us USA,FWMF,D.C. United,21,2002,13.0,21,12,10,7,4,5,19,26.3,14,6,0,6,6,27,2,0,Matches
434,Yuya Kubo,jp JPN,MFFW,FC Cincinnati,29,1993,11.9,18,12,9,8,1,4,21,19.0,17,9,1,8,10,28,8,0,Matches
435,Jojea Kwizera,rw RWA,DF,CF Montréal,24,1999,1.5,3,1,1,1,1,1,3,33.3,2,0,0,0,1,4,0,0,Matches
436,Mathías Laborda,uy URU,DF,Vancouver W'caps,23,1999,17.1,41,23,30,9,2,19,44,43.2,25,9,5,4,23,64,61,0,Matches
437,Kevon Lambert,jm JAM,DF,Real Salt Lake,25,1997,0.3,1,0,0,0,1,0,0,,0,0,0,0,1,2,3,0,Matches
438,Lassi Lappalainen,fi FIN,DFFW,CF Montréal,24,1998,11.5,19,14,6,10,3,10,25,40.0,15,17,0,17,8,27,12,0,Matches
439,Oliver Larraz,us USA,MF,Colorado Rapids,21,2001,0.2,1,1,1,0,0,0,0,,0,1,0,1,0,1,0,0,Matches
440,Richie Laryea,ca CAN,DF,Toronto FC,28,1995,17.9,35,19,23,12,0,18,34,52.9,16,19,8,11,22,57,31,1,Matches
441,Richie Laryea,ca CAN,FWDF,Vancouver W'caps,28,1995,10.5,20,17,12,4,4,7,9,77.8,2,3,1,2,8,28,7,1,Matches
442,Ariel Lassiter,cr CRC,FWMF,Inter Miami,28,1994,1.7,3,2,0,1,2,2,4,50.0,2,2,0,2,1,4,0,0,Matches
443,Ariel Lassiter,cr CRC,DFMF,CF Montréal,28,1994,17.7,7,7,3,4,0,4,9,44.4,5,9,1,8,13,20,15,0,Matches
444,Kemar Lawrence,jm JAM,DF,Minnesota Utd,30,1992,12.4,17,13,10,5,2,10,13,76.9,3,16,7,9,16,33,27,0,Matches
445,Randall Leal,cr CRC,MFFW,Nashville SC,26,1997,12.7,25,15,8,11,6,9,32,28.1,23,10,1,9,7,32,4,0,Matches
446,Richy Ledezma,us USA,MFFW,NYCFC,22,2000,13.2,7,4,2,5,0,1,8,12.5,7,8,1,7,6,13,2,0,Matches
447,Kelvin Leerdam,sr SUR,DF,LA Galaxy,32,1990,13.4,13,6,8,3,2,10,15,66.7,5,10,6,4,9,22,63,0,Matches
448,Tim Leibold,de GER,DF,Sporting KC,29,1993,9.7,22,13,8,10,4,9,22,40.9,13,11,1,10,17,39,14,0,Matches
449,Brooks Lennon,us USA,DF,Atlanta Utd,25,1997,32.0,37,22,19,15,3,21,37,56.8,16,33,12,21,27,64,80,0,Matches
450,Jonathan Lewis,us USA,FWMF,Colorado Rapids,25,1997,13.2,10,7,2,7,1,4,11,36.4,7,4,2,2,4,14,3,0,Matches
Rk
451,Danny Leyva,us USA,MF,Colorado Rapids,19,2003,7.1,7,4,4,3,0,3,14,21.4,11,7,3,4,11,18,6,0,Matches
452,Danny Leyva,us USA,MFFW,Seattle Sounders,19,2003,0.2,0,0,0,0,0,0,1,0.0,1,1,0,1,2,2,1,0,Matches
453,Nick Lima,us USA,DF,Austin,28,1994,27.0,27,19,16,9,2,20,44,45.5,24,25,7,18,22,49,62,0,Matches
454,Jaylin Lindsey,us USA,DF,Charlotte,22,2000,14.5,30,19,14,11,5,11,23,47.8,12,23,4,19,15,45,35,0,Matches
455,Sebastian Lletget,us USA,MFFW,FC Dallas,30,1992,12.9,17,10,5,7,5,10,22,45.5,12,15,6,9,9,26,12,1,Matches
456,Saba Lobzhanidze,ge GEO,FW,Atlanta Utd,28,1994,5.2,1,0,1,0,0,0,1,0.0,1,5,0,5,2,3,3,0,Matches
457,Robin Lod,fi FIN,MFFW,Minnesota Utd,29,1993,10.0,18,10,8,8,2,4,21,19.0,17,9,1,8,6,24,10,1,Matches
458,Nicolás Lodeiro,uy URU,MFFW,Seattle Sounders,33,1989,27.5,47,27,15,22,10,24,65,36.9,41,22,1,21,16,63,9,0,Matches
459,Jasper Löffelsend,de GER,MF,Real Salt Lake,25,1997,12.6,37,24,16,20,1,16,39,41.0,23,16,2,14,11,48,22,0,Matches
460,Aaron Long,us USA,DF,LAFC,30,1992,16.9,30,20,18,10,2,11,13,84.6,2,20,9,11,20,50,75,0,Matches
461,Erik López,py PAR,FWMF,Atlanta Utd,21,2001,0.3,0,0,0,0,0,0,1,0.0,1,1,0,1,0,0,0,0,Matches
462,Marvin Loría,cr CRC,FWMF,Portland Timbers,25,1997,8.4,7,5,6,1,0,3,10,30.0,7,9,0,9,13,20,1,0,Matches
463,Daniel Lovitz,us USA,DF,Nashville SC,31,1991,31.6,55,33,26,15,14,32,54,59.3,22,35,10,25,28,83,73,0,Matches
464,Damion Lowe,jm JAM,DF,Philadelphia Union,29,1993,13.7,31,19,23,7,1,16,32,50.0,16,15,8,7,35,66,68,0,Matches
465,Eduard Löwen,de GER,MF,St. Louis,26,1997,25.6,64,42,27,27,10,33,76,43.4,43,41,11,30,16,80,29,0,Matches
466,Favian Loyola,cl CHI,MF,Orlando City,17,2005,0.0,0,0,0,0,0,0,0,,0,0,0,0,0,0,0,0,Matches
467,Diego Luna,us USA,MFFW,Real Salt Lake,19,2003,13.3,11,8,5,5,1,5,16,31.3,11,20,2,18,15,26,6,1,Matches
468,Adam Lundqvist,se SWE,DFMF,Austin,28,1994,9.6,29,15,16,10,3,17,33,51.5,16,17,4,13,12,41,22,0,Matches
469,Benjamin Lundt,de GER,GK,St. Louis,27,1995,1.0,0,0,0,0,0,0,0,,0,0,0,0,0,0,0,0,Matches
470,Luquinhas,br BRA,MFFW,NY Red Bulls,26,1996,22.2,28,15,4,15,9,12,32,37.5,20,24,1,23,14,42,2,0,Matches
471,Jack Lynn,us USA,MFFW,Orlando City,23,2000,0.4,0,0,0,0,0,0,0,,0,0,0,0,1,1,2,0,Matches
472,Larrys Mabiala,cd COD,DF,Portland Timbers,35,1987,9.8,13,8,10,3,0,9,16,56.3,7,12,7,5,11,24,40,0,Matches
473,Aimé Mabika,zm ZAM,DF,Toronto FC,24,1998,16.8,25,19,21,4,0,11,17,64.7,6,36,28,8,11,36,61,1,Matches
474,Zac MacMath,us USA,GK,Real Salt Lake,31,1991,27.5,0,0,0,0,0,0,0,,0,0,0,0,1,1,17,3,Matches
475,Lukas MacNaughton,ca CAN,DF,Toronto FC,27,1995,2.0,3,1,2,1,0,2,2,100.0,0,2,2,0,2,5,6,1,Matches
Rk
476,Lukas MacNaughton,ca CAN,DF,Nashville SC,27,1995,11.9,11,8,8,3,0,4,10,40.0,6,10,7,3,30,41,49,1,Matches
477,Talles Magno,br BRA,FW,NYCFC,20,2002,21.2,30,16,8,15,7,14,22,63.6,8,16,0,16,5,35,8,0,Matches
478,Jack Maher,us USA,DF,Nashville SC,23,1999,32.0,37,22,26,10,1,20,28,71.4,8,25,17,8,23,60,128,0,Matches
479,Cassius Mailula,za RSA,FWMF,Toronto FC,21,2001,0.8,0,0,0,0,0,0,2,0.0,2,0,0,0,1,1,0,0,Matches
480,Christian Makoun,ve VEN,DFMF,NE Revolution,22,2000,5.4,14,6,7,7,0,5,8,62.5,3,6,2,4,6,20,15,0,Matches
481,Adilson Malanda,fr FRA,DF,Charlotte,21,2001,28.5,39,24,27,11,1,23,37,62.2,14,40,23,17,32,71,116,2,Matches
482,Denil Maldonado,hn HON,DF,LAFC,24,1998,18.6,21,14,12,9,0,12,27,44.4,15,19,13,6,23,44,65,0,Matches
483,Machop Malual,ss SSD,FWMF,Atlanta Utd,24,1998,5.2,7,4,2,5,0,2,2,100.0,0,9,1,8,3,10,0,0,Matches
484,Elias Manoel,br BRA,FW,NY Red Bulls,21,2001,18.4,11,5,4,2,5,4,12,33.3,8,24,0,24,4,15,5,0,Matches
485,J.T. Marcinkowski,us USA,GK,SJ Earthquakes,25,1997,12.4,0,0,0,0,0,0,0,,0,0,0,0,0,0,6,0,Matches
486,Paul Marie,fr FRA,DF,SJ Earthquakes,27,1995,22.3,65,37,41,17,7,37,80,46.3,43,41,7,34,26,91,47,0,Matches
487,Anthony Markanich,ph PHI,DF,Colorado Rapids,23,1999,3.8,13,7,9,4,0,7,14,50.0,7,8,2,6,5,18,17,0,Matches
488,Anthony Markanich,ph PHI,DF,St. Louis,23,1999,7.3,18,10,7,7,4,7,15,46.7,8,11,3,8,14,32,14,0,Matches
489,George Marks,us USA,GK,Charlotte,23,1999,7.0,1,1,1,0,0,0,0,,0,0,0,0,0,1,4,1,Matches
490,Mikael Marques,se SWE,MF,Minnesota Utd,21,2001,0.1,0,0,0,0,0,0,0,,0,0,0,0,0,0,1,0,Matches
491,Jahkeele Marshall-Rutty,ca CAN,MFDF,Toronto FC,18,2004,12.8,29,15,19,9,1,12,24,50.0,12,13,1,12,6,35,12,0,Matches
492,Alonso Martínez,cr CRC,FWDF,NYCFC,24,1998,0.4,1,1,0,1,0,1,1,100.0,0,4,0,4,0,1,0,0,Matches
493,José Martínez,es ESP,DF,FC Dallas,29,1993,15.9,18,12,13,4,1,9,13,69.2,4,14,8,6,16,34,66,0,Matches
494,Josef Martínez,ve VEN,FW,Inter Miami,29,1993,19.3,5,3,2,0,3,3,8,37.5,5,5,1,4,1,6,12,0,Matches
495,Luís Martins,pt POR,DF,Vancouver W'caps,30,1992,18.0,35,23,17,14,4,21,34,61.8,13,8,2,6,25,60,37,1,Matches
496,Thiago Martins,br BRA,DF,NYCFC,27,1995,24.3,30,20,23,7,0,19,24,79.2,5,21,10,11,12,42,122,1,Matches
497,Alexandru Mățan,ro ROU,MFFW,Columbus Crew,23,1999,25.2,14,11,7,6,1,6,24,25.0,18,19,1,18,12,26,3,0,Matches
498,Jimmy Maurer,us USA,GK,FC Dallas,34,1988,4.8,0,0,0,0,0,0,0,,0,0,0,0,0,0,2,0,Matches
499,Chris Mavinga,cd COD,DF,LA Galaxy,31,1991,12.5,8,4,6,2,0,4,8,50.0,4,16,11,5,10,18,43,2,Matches
500,Max,br BRA,MFFW,Colorado Rapids,21,2001,7.4,18,11,11,4,3,10,19,52.6,9,12,0,12,7,25,12,0,Matches
Rk
501,Andreas Maxsø,dk DEN,DF,Colorado Rapids,28,1994,32.5,13,5,8,5,0,6,12,50.0,6,29,25,4,17,30,122,0,Matches
502,Olivier Mbaizo,cm CMR,DF,Philadelphia Union,25,1997,20.4,26,15,13,12,1,8,26,30.8,18,13,2,11,23,49,27,2,Matches
503,Hugo-Hilaire Mbongue Mbongue,ca CAN,FWMF,Toronto FC,18,2004,2.9,1,0,0,1,0,0,2,0.0,2,2,0,2,0,1,3,0,Matches
504,John McCarthy,us USA,GK,LAFC,30,1992,25.0,2,2,2,0,0,1,1,100.0,0,0,0,0,1,3,7,2,Matches
505,Dax McCarty,us USA,MF,Nashville SC,35,1987,21.0,48,28,23,20,5,26,52,50.0,26,26,12,14,20,68,36,0,Matches
506,Jack McGlynn,us USA,MF,Philadelphia Union,19,2003,18.0,28,13,17,9,2,20,44,45.5,24,11,1,10,13,41,14,0,Matches
507,Zac McGraw,ca CAN,DF,Portland Timbers,25,1997,26.9,44,20,28,16,0,27,40,67.5,13,43,28,15,42,86,159,2,Matches
508,Duncan McGuire,us USA,FW,Orlando City,21,2001,15.4,5,3,0,2,3,1,5,20.0,4,13,1,12,2,7,17,0,Matches
509,Kendall McIntosh,us USA,GK,Sporting KC,29,1994,13.2,0,0,0,0,0,0,1,0.0,1,1,0,1,0,0,4,0,Matches
510,Thomas McNamara,us USA,MFFW,NE Revolution,31,1991,2.1,1,1,0,0,1,1,3,33.3,2,1,1,0,2,3,3,0,Matches
511,Christopher McVey,se SWE,DF,Inter Miami,25,1997,13.5,21,9,11,8,2,9,20,45.0,11,14,8,6,23,44,34,0,Matches
512,Jimmy Medranda,co COL,MFDF,Columbus Crew,28,1994,1.2,6,3,5,1,0,1,3,33.3,2,3,1,2,4,10,0,0,Matches
513,Tim Melia,us USA,GK,Sporting KC,36,1986,15.8,0,0,0,0,0,0,0,,0,0,0,0,0,0,8,1,Matches
514,Vinicius Mello,br BRA,FW,Charlotte,20,2002,0.6,0,0,0,0,0,0,1,0.0,1,0,0,0,0,0,2,0,Matches
515,Jonathan Mensah,gh GHA,DF,SJ Earthquakes,32,1990,21.7,8,6,5,3,0,5,10,50.0,5,28,17,11,20,28,92,1,Matches
516,Justin Meram,iq IRQ,FWMF,Charlotte,34,1988,14.8,17,10,5,7,5,12,29,41.4,17,12,0,12,7,24,11,0,Matches
517,Justin Meram,iq IRQ,FWMF,Real Salt Lake,34,1988,2.0,10,9,5,5,0,7,11,63.6,4,2,1,1,4,14,5,0,Matches
518,Lionel Messi,ar ARG,FWMF,Inter Miami,35,1987,4.1,1,1,0,1,0,0,2,0.0,2,0,0,0,1,2,0,0,Matches
519,Matt Miazga,us USA,DF,FC Cincinnati,27,1995,26.5,25,17,18,7,0,17,20,85.0,3,33,26,7,36,61,136,1,Matches
520,Micael,br BRA,DF,Houston Dynamo,22,2000,21.9,38,25,28,7,3,18,24,75.0,6,31,17,14,28,66,125,2,Matches
521,Novak Mićović,rs SRB,GK,LA Galaxy,21,2001,2.0,0,0,0,0,0,0,0,,0,0,0,0,0,0,0,0,Matches
522,Matko Miljevic,us USA,MFFW,CF Montréal,21,2001,1.5,2,1,0,1,1,0,3,0.0,3,0,0,0,1,3,0,0,Matches
523,Eric Miller,us USA,DF,Portland Timbers,30,1993,13.4,16,12,9,4,3,12,21,57.1,9,9,6,3,7,23,45,1,Matches
524,Kamal Miller,ca CAN,DF,Inter Miami,25,1997,20.5,29,22,21,8,0,23,34,67.6,11,17,10,7,25,54,58,2,Matches
525,Kamal Miller,ca CAN,DF,CF Montréal,25,1997,5.3,3,2,1,1,1,2,5,40.0,3,5,3,2,6,9,12,0,Matches
Rk
526,Tyler Miller,us USA,GK,D.C. United,29,1993,24.5,0,0,0,0,0,0,2,0.0,2,0,0,0,2,2,21,5,Matches
527,Kevin Molino,tt TRI,MFFW,Columbus Crew,32,1990,0.7,4,3,2,1,1,1,1,100.0,0,2,0,2,0,4,0,0,Matches
528,Alex Monis,ph PHI,FW,Chicago Fire,19,2003,0.1,1,1,0,1,0,1,1,100.0,0,0,0,0,1,2,0,0,Matches
529,Jamiro Monteiro,cv CPV,MF,SJ Earthquakes,29,1993,23.6,37,24,15,18,4,10,48,20.8,38,23,2,21,15,52,4,0,Matches
530,Fredy Montero,co COL,FWMF,Seattle Sounders,35,1987,4.8,7,6,2,3,2,2,7,28.6,5,1,0,1,0,7,0,0,Matches
531,Shaq Moore,us USA,DF,Nashville SC,26,1996,30.8,80,50,53,21,6,42,60,70.0,18,33,11,22,25,105,59,0,Matches
532,Felipe Mora,cl CHI,FW,Portland Timbers,29,1993,9.1,4,2,0,3,1,0,4,0.0,4,1,1,0,0,4,3,0,Matches
533,Joseph Mora,cr CRC,DF,Charlotte,30,1993,2.1,5,3,4,1,0,3,5,60.0,2,4,0,4,4,9,6,0,Matches
534,Alfredo Morales,us USA,MF,NYCFC,32,1990,12.9,23,9,12,10,1,9,21,42.9,12,17,4,13,11,34,20,0,Matches
535,Maximiliano Moralez,ar ARG,MFFW,NYCFC,35,1987,3.5,5,3,1,3,1,2,6,33.3,4,4,1,3,3,8,0,0,Matches
536,Steven Moreira,cv CPV,DF,Columbus Crew,28,1994,32.5,39,20,26,13,0,21,37,56.8,16,36,13,23,21,60,58,2,Matches
537,Junior Moreno,ve VEN,MF,FC Cincinnati,29,1993,25.0,35,19,19,13,3,17,32,53.1,15,31,13,18,22,57,24,0,Matches
538,Santiago Moreno,co COL,FWMF,Portland Timbers,22,2000,25.9,49,24,14,24,11,14,56,25.0,42,38,3,35,23,72,11,0,Matches
539,Lewis Morgan,sct SCO,MFFW,NY Red Bulls,26,1996,3.3,1,1,0,1,0,0,1,0.0,1,5,0,5,1,2,3,0,Matches
540,Aidan Morris,us USA,MF,Columbus Crew,21,2001,28.7,98,58,36,49,13,34,97,35.1,63,33,3,30,44,142,11,0,Matches
541,Jordan Morris,us USA,FW,Seattle Sounders,28,1994,22.0,12,9,5,6,1,4,8,50.0,4,13,2,11,3,15,11,0,Matches
542,Edwin Mosquera,co COL,FWMF,Atlanta Utd,21,2001,4.9,7,6,1,4,2,2,5,40.0,3,3,2,1,4,11,2,0,Matches
543,Yerson Mosquera,co COL,DF,FC Cincinnati,21,2001,25.0,45,37,31,11,3,20,37,54.1,17,31,16,15,47,92,112,1,Matches
544,Jean Mota,br BRA,MF,Inter Miami,29,1993,10.1,37,22,21,13,3,23,46,50.0,23,14,4,10,11,48,10,0,Matches
545,Chris Mueller,us USA,FWMF,Chicago Fire,26,1996,7.9,7,7,2,4,1,5,12,41.7,7,14,1,13,3,10,6,0,Matches
546,Hany Mukhtar,de GER,FWMF,Nashville SC,27,1995,31.5,16,10,0,9,7,10,33,30.3,23,15,0,15,6,22,5,0,Matches
547,José Mulato,co COL,FWMF,FC Dallas,20,2003,1.2,2,2,1,1,0,1,2,50.0,1,0,0,0,0,2,0,0,Matches
548,O'Vonte Mullings,ca CAN,MFDF,NY Red Bulls,22,2000,0.5,1,1,1,0,0,0,0,,0,1,0,1,2,3,0,0,Matches
549,Daniel Munie,us USA,DF,SJ Earthquakes,22,2000,1.2,0,0,0,0,0,0,1,0.0,1,4,4,0,1,1,12,0,Matches
550,Ian Murphy,us USA,DF,FC Cincinnati,23,2000,16.9,34,20,21,11,2,12,23,52.2,11,20,8,12,10,44,42,0,Matches
Rk
551,Daniel Musovski,us USA,FW,Real Salt Lake,27,1995,13.4,15,11,4,10,1,3,19,15.8,16,10,1,9,1,16,9,0,Matches
552,Alex Muyl,us USA,MFDF,Nashville SC,27,1995,22.7,46,19,15,26,5,17,54,31.5,37,37,5,32,22,68,25,0,Matches
553,Tristan Muyumba,,MF,Atlanta Utd,25,1997,9.1,31,15,16,13,2,12,27,44.4,15,13,1,12,4,35,2,1,Matches
554,Darlington Nagbe,us USA,MF,Columbus Crew,32,1990,31.0,29,15,9,13,7,14,32,43.8,18,23,5,18,21,50,20,0,Matches
555,Andy Najar,hn HON,DF,D.C. United,29,1993,12.3,29,20,18,9,2,16,36,44.4,20,14,3,11,17,46,17,0,Matches
556,Federico Navarro,ar ARG,MF,Chicago Fire,22,2000,12.2,35,24,16,18,1,13,34,38.2,21,14,7,7,17,52,14,1,Matches
557,Miguel Navarro,ve VEN,DF,Chicago Fire,23,1999,21.9,45,30,29,13,3,22,34,64.7,12,38,7,31,45,90,66,1,Matches
558,Rafael Navarro,br BRA,FW,Colorado Rapids,22,2000,9.8,7,6,0,6,1,0,8,0.0,8,8,2,6,5,12,7,0,Matches
559,Hassan Ndam,cm CMR,DF,NY Red Bulls,24,1998,7.8,16,11,10,6,0,11,15,73.3,4,14,6,8,15,31,26,0,Matches
560,Logan Ndenbe,be BEL,DF,Sporting KC,22,2000,17.1,24,15,14,7,3,10,24,41.7,14,14,2,12,24,48,24,0,Matches
561,Jalen Neal,us USA,DF,LA Galaxy,19,2003,14.3,13,10,10,3,0,7,13,53.8,6,21,12,9,22,35,58,0,Matches
562,Dylan Nealis,us USA,DF,NY Red Bulls,24,1998,11.5,32,19,16,12,4,20,34,58.8,14,17,1,16,16,48,28,0,Matches
563,Sean Nealis,us USA,DF,NY Red Bulls,26,1997,30.2,44,28,27,15,2,37,59,62.7,22,32,12,20,30,74,106,0,Matches
564,Franco Negri,ar ARG,DF,Inter Miami,27,1995,14.8,35,21,14,19,2,18,33,54.5,15,25,3,22,26,61,27,0,Matches
565,John Nelson,us USA,DF,St. Louis,24,1998,14.1,31,20,15,13,3,18,39,46.2,21,18,2,16,16,47,43,1,Matches
566,Jake Nerwinski,us USA,DF,St. Louis,28,1994,24.6,40,22,24,12,4,20,56,35.7,36,29,4,25,38,78,64,2,Matches
567,Harvey Neville,ie IRL,DFMF,Inter Miami,20,2002,2.2,6,4,4,2,0,5,11,45.5,6,4,1,3,4,10,4,0,Matches
568,Jean-Claude Ngando,cm CMR,MFFW,Vancouver W'caps,23,1999,0.9,4,4,0,3,1,2,4,50.0,2,1,0,1,1,5,2,0,Matches
569,Sam Nicholson,sct SCO,MFDF,Colorado Rapids,28,1995,16.6,13,9,6,4,3,4,18,22.2,14,17,4,13,13,26,27,0,Matches
570,Jarosław Niezgoda,pl POL,FW,Portland Timbers,27,1995,7.3,7,3,2,4,1,2,7,28.6,5,6,2,4,2,9,4,0,Matches
571,Joakim Nilsson,se SWE,DF,St. Louis,28,1994,6.6,12,9,8,4,0,9,12,75.0,3,20,14,6,12,24,29,0,Matches
572,Matt Nocita,us USA,DF,NY Red Bulls,22,2000,0.3,2,2,2,0,0,0,1,0.0,1,0,0,0,2,4,1,0,Matches
573,Nolan Norris,us USA,MF,FC Dallas,17,2005,1.5,2,2,1,1,0,2,3,66.7,1,1,1,0,0,2,2,0,Matches
574,Tsiki Ntsabeleng,za RSA,MFFW,FC Dallas,24,1998,3.9,7,2,3,3,1,3,6,50.0,3,4,1,3,3,10,2,0,Matches
575,Obinna Nwobodo,ng NGA,MF,FC Cincinnati,26,1996,28.7,87,62,32,45,10,38,87,43.7,49,34,1,33,55,142,45,0,Matches
Rk
576,Moses Nyeman,us USA,MF,Real Salt Lake,19,2003,0.3,1,0,1,0,0,0,1,0.0,1,1,0,1,0,1,0,0,Matches
577,Lewis O'Brien,eng ENG,MF,D.C. United,24,1998,16.8,38,21,12,20,6,19,49,38.8,30,21,6,15,17,55,13,2,Matches
578,Shane O'Neill,us USA,DF,Toronto FC,29,1993,10.4,17,13,11,6,0,10,15,66.7,5,14,8,6,16,33,28,0,Matches
579,Kevin O'Toole,us USA,DFMF,NYCFC,24,1998,13.3,22,14,15,4,3,18,33,54.5,15,23,7,16,14,36,34,0,Matches
580,Jáder Obrian,co COL,FWMF,FC Dallas,27,1995,21.0,23,10,9,12,2,10,42,23.8,32,18,0,18,13,36,7,0,Matches
581,Chinonso Offor,ng NGA,FW,CF Montréal,22,2000,16.8,9,6,2,2,5,2,12,16.7,10,12,2,10,2,11,18,0,Matches
582,Braian Ojeda,py PAR,MF,Real Salt Lake,22,2000,24.0,55,32,18,30,7,26,60,43.3,34,27,6,21,41,96,21,0,Matches
583,Martín Ojeda,ar ARG,FWMF,Orlando City,24,1998,19.5,22,17,7,10,5,8,33,24.2,25,30,0,30,13,35,23,0,Matches
584,Cristian Olivera,uy URU,FW,LAFC,20,2002,6.7,14,8,4,5,5,7,14,50.0,7,7,0,7,2,16,2,0,Matches
585,Tani Oluwaseyi,ca CAN,FW,Minnesota Utd,22,2000,0.1,2,1,1,1,0,0,0,,0,0,0,0,0,2,1,0,Matches
586,Wyatt Omsberg,us USA,DF,Chicago Fire,27,1995,7.9,7,2,6,1,0,3,6,50.0,3,14,13,1,14,21,33,0,Matches
587,Kwadwo Opoku,gh GHA,FW,LAFC,21,2001,13.1,13,8,2,8,3,8,20,40.0,12,11,2,9,2,15,5,0,Matches
588,Kwadwo Opoku,gh GHA,FW,CF Montréal,21,2001,10.3,6,3,2,2,2,2,8,25.0,6,6,0,6,5,11,2,0,Matches
589,Nathan Ordaz,sv SLV,FW,LAFC,19,2004,2.9,4,1,1,1,2,0,2,0.0,2,4,0,4,0,4,1,0,Matches
590,Arquimides Ordonez,gt GUA,FW,FC Cincinnati,19,2003,3.1,6,5,1,2,3,1,2,50.0,1,2,1,1,0,6,0,0,Matches
591,Prince Osei Owusu,de GER,FW,Toronto FC,26,1997,2.9,3,2,1,2,0,2,2,100.0,0,1,0,1,1,4,6,0,Matches
592,Jonathan Osorio,ca CAN,MFFW,Toronto FC,30,1992,20.8,22,16,9,8,5,9,18,50.0,9,10,0,10,16,38,11,0,Matches
593,Tomáš Ostrák,cz CZE,MFFW,St. Louis,22,2000,12.8,25,17,11,9,5,11,31,35.5,20,11,0,11,2,27,5,0,Matches
594,Bryan Oviedo,cr CRC,DF,Real Salt Lake,32,1990,19.9,40,27,27,8,5,20,38,52.6,18,17,7,10,24,64,49,0,Matches
595,Devin Padelford,us USA,DF,Minnesota Utd,20,2003,1.7,3,2,2,1,0,1,2,50.0,1,1,0,1,1,4,3,0,Matches
596,Maarten Paes,id IDN,GK,FC Dallas,24,1998,29.1,3,1,3,0,0,3,3,100.0,0,0,0,0,0,3,18,2,Matches
597,Nelson Palacio,co COL,MF,Real Salt Lake,21,2001,9.6,12,10,10,2,0,8,22,36.4,14,7,2,5,10,22,11,0,Matches
598,Diego Palacios,ec ECU,DF,LAFC,23,1999,27.0,89,47,48,32,9,45,70,64.3,25,45,6,39,55,144,57,0,Matches
599,Sergi Palencia,es ESP,DF,LAFC,26,1996,14.0,43,30,30,11,2,26,42,61.9,16,21,3,18,22,65,20,0,Matches
600,Victor Pálsson,is ISL,DFMF,D.C. United,31,1991,17.5,28,16,11,15,2,14,27,51.9,13,17,5,12,25,53,58,0,Matches
Rk
601,Jack Panayotou,us USA,MFDF,NE Revolution,18,2004,3.6,9,6,4,3,2,4,9,44.4,5,3,0,3,2,11,2,0,Matches
602,Elliot Panicco,us USA,GK,Nashville SC,26,1996,2.0,0,0,0,0,0,0,0,,0,0,0,0,0,0,0,0,Matches
603,James Pantemis,ca CAN,GK,CF Montréal,25,1997,1.9,0,0,0,0,0,0,0,,0,0,0,0,0,0,2,0,Matches
604,Cristhian Paredes,py PAR,MF,Portland Timbers,24,1998,21.2,73,38,26,35,12,32,62,51.6,30,27,5,22,18,91,19,0,Matches
605,Isaiah Parente,us USA,MFFW,Columbus Crew,22,2000,0.5,2,2,0,2,0,0,5,0.0,5,1,0,1,1,3,1,0,Matches
606,Tim Parker,us USA,DF,St. Louis,29,1993,28.5,29,20,20,6,3,13,27,48.1,14,26,20,6,45,74,151,1,Matches
607,Keaton Parks,us USA,MF,NYCFC,25,1997,27.9,51,27,22,25,4,24,48,50.0,24,33,10,23,22,73,42,0,Matches
608,Ilijah Paul,us USA,FWMF,Real Salt Lake,20,2002,1.2,1,1,0,0,1,0,2,0.0,2,0,0,0,0,1,1,0,Matches
609,João Paulo Mior,br BRA,MF,Seattle Sounders,31,1991,27.3,70,39,35,29,6,49,103,47.6,54,30,7,23,48,118,47,0,Matches
610,Adam Pearlman,ca CAN,DF,Toronto FC,17,2005,0.1,1,0,1,0,0,0,0,,0,1,0,1,0,1,0,1,Matches
611,Matías Pellegrini,ar ARG,FWMF,NYCFC,22,2000,12.8,24,15,11,10,3,11,37,29.7,26,23,1,22,7,31,10,1,Matches
612,Andrés Perea,us USA,MF,Philadelphia Union,22,2000,1.7,3,2,1,2,0,1,4,25.0,3,3,1,2,2,5,7,0,Matches
613,Andrés Perea,us USA,MF,NYCFC,22,2000,8.6,14,12,5,8,1,7,17,41.2,10,9,2,7,8,22,7,0,Matches
614,Daniel Pereira,ve VEN,MF,Austin,22,2000,28.1,39,23,19,16,4,13,73,17.8,60,35,8,27,32,71,25,2,Matches
615,Gabriel Pereira,br BRA,FWMF,NYCFC,21,2001,17.1,14,11,5,7,2,4,14,28.6,10,12,0,12,9,23,7,0,Matches
616,Mauricio Pereyra,uy URU,MF,Orlando City,32,1990,23.5,40,28,15,19,6,23,52,44.2,29,11,2,9,11,51,8,1,Matches
617,Jonathan Perez,mx MEX,DFMF,LA Galaxy,20,2003,1.3,3,1,1,1,1,0,1,0.0,1,1,0,1,2,5,1,0,Matches
618,Miguel Perez,us USA,MF,St. Louis,17,2005,6.8,23,12,13,6,4,13,28,46.4,15,12,1,11,10,33,9,0,Matches
619,Jordan Perruzza,ca CAN,FWMF,Toronto FC,22,2001,1.4,1,0,0,0,1,0,1,0.0,1,0,0,0,0,1,0,0,Matches
620,Luca Petrasso,ca CAN,DFFW,Orlando City,22,2000,4.8,8,5,3,3,2,4,6,66.7,2,4,1,3,3,11,6,0,Matches
621,Raoul Petretta,it ITA,DF,Toronto FC,25,1997,19.4,57,37,32,20,5,39,50,78.0,11,20,5,15,25,82,46,0,Matches
622,Đorđe Petrović,rs SRB,GK,NE Revolution,23,1999,22.0,0,0,0,0,0,0,1,0.0,1,0,0,0,1,1,7,1,Matches
623,Fafà Picault,ht HAI,FWMF,Nashville SC,31,1991,18.0,21,16,9,9,3,4,15,26.7,11,24,4,20,15,36,13,0,Matches
624,Selmir Pidro,ba BIH,DF,St. Louis,24,1998,0.5,3,1,1,1,1,1,2,50.0,1,1,1,0,0,3,1,0,Matches
625,Kayden Pierre,us USA,DF,Sporting KC,19,2003,0.1,0,0,0,0,0,0,0,,0,0,0,0,0,0,0,0,Matches
Rk
626,Samuel Piette,ca CAN,MF,CF Montréal,28,1994,12.1,27,18,14,13,0,14,30,46.7,16,12,4,8,11,38,16,0,Matches
627,Mauricio Pineda,us USA,DFMF,Chicago Fire,25,1997,17.4,36,19,25,9,2,21,33,63.6,12,31,10,21,27,63,56,0,Matches
628,Donovan Pines,us USA,DF,D.C. United,24,1998,20.5,36,27,22,13,1,20,27,74.1,7,22,15,7,45,81,88,1,Matches
629,Malik Pinto,us USA,MF,FC Cincinnati,20,2002,4.4,11,4,5,5,1,6,17,35.3,11,10,4,6,1,12,6,0,Matches
630,Gabriel Pirani,br BRA,MF,D.C. United,20,2002,9.2,12,8,4,7,1,2,7,28.6,5,7,0,7,2,14,1,0,Matches
631,Rodolfo Pizarro,mx MEX,MFFW,Inter Miami,28,1994,10.3,19,7,6,5,8,10,17,58.8,7,11,1,10,4,23,2,0,Matches
632,Matt Polster,us USA,MFDF,NE Revolution,29,1993,30.4,54,30,23,29,2,31,65,47.7,34,23,9,14,45,99,44,3,Matches
633,Célio Pompeu,br BRA,FWMF,St. Louis,23,1999,10.8,36,26,14,15,7,18,41,43.9,23,28,1,27,7,43,6,0,Matches
634,Paxton Pomykal,us USA,MF,FC Dallas,23,1999,17.8,37,27,16,15,6,18,49,36.7,31,26,7,19,28,65,15,0,Matches
635,Alvas Powell,jm JAM,DF,FC Cincinnati,28,1994,10.6,23,14,16,7,0,17,29,58.6,12,12,4,8,12,35,34,0,Matches
636,Jack Price,eng ENG,MF,Colorado Rapids,30,1992,0.4,2,1,1,0,1,1,1,100.0,0,0,0,0,1,3,0,0,Matches
637,Ralph Priso-Mbongue,ca CAN,MF,Colorado Rapids,20,2002,11.5,28,14,18,7,3,12,27,44.4,15,11,1,10,9,37,12,0,Matches
638,Andrew Privett,us USA,DF,Charlotte,22,2000,11.6,16,11,5,9,2,6,15,40.0,9,10,1,9,11,27,23,2,Matches
639,Kacper Przybyłko,pl POL,FW,Chicago Fire,29,1993,10.8,6,3,1,4,1,3,5,60.0,2,10,3,7,3,9,15,0,Matches
640,Riqui Puig,es ESP,MFFW,LA Galaxy,23,1999,28.1,19,13,5,8,6,12,26,46.2,14,13,1,12,12,31,2,0,Matches
641,Teemu Pukki,fi FIN,FW,Minnesota Utd,32,1990,11.5,0,0,0,0,0,0,6,0.0,6,4,0,4,1,1,8,0,Matches
642,Alan Pulido,mx MEX,FW,Sporting KC,31,1991,24.5,13,7,4,5,4,1,10,10.0,9,7,2,5,4,17,11,0,Matches
643,John Pulskamp,us USA,GK,Sporting KC,21,2001,5.0,1,0,1,0,0,1,1,100.0,0,0,0,0,0,1,3,0,Matches
644,Facundo Quignon,ar ARG,MF,FC Dallas,29,1993,21.3,52,27,26,22,4,24,54,44.4,30,25,4,21,30,82,43,0,Matches
645,Nelson Quiñones,co COL,FWMF,Houston Dynamo,20,2002,16.4,36,27,20,12,4,10,21,47.6,11,14,0,14,14,50,8,1,Matches
646,Philip Quinton,us USA,DF,Columbus Crew,23,1999,10.4,10,4,7,2,1,5,14,35.7,9,8,5,3,18,28,33,0,Matches
647,Romell Quioto,hn HON,FW,CF Montréal,31,1991,8.9,5,2,0,4,1,0,3,0.0,3,2,1,1,0,5,7,0,Matches
648,Nemanja Radoja,rs SRB,MF,Sporting KC,29,1993,19.0,33,21,10,21,2,23,42,54.8,19,14,2,12,29,62,5,0,Matches
649,Aleksandar Radovanović,rs SRB,DF,Austin,29,1993,3.9,7,4,4,3,0,0,3,0.0,3,4,2,2,6,13,13,1,Matches
650,Jeremy Rafanello,us USA,MF,Philadelphia Union,22,2000,0.1,0,0,0,0,0,0,1,0.0,1,0,0,0,0,0,1,0,Matches
Rk
651,Jackson Ragen,us USA,DF,Seattle Sounders,24,1998,31.6,32,22,29,3,0,21,35,60.0,14,53,31,22,31,63,142,0,Matches
652,Brooklyn Raines,us USA,MFFW,Houston Dynamo,17,2005,2.2,4,4,2,2,0,2,2,100.0,0,3,0,3,4,8,1,0,Matches
653,Christian Ramirez,us USA,FWMF,Columbus Crew,31,1991,17.9,1,0,0,1,0,0,5,0.0,5,8,1,7,2,3,15,0,Matches
654,Greg Ranjitsingh,tt TRI,GK,Toronto FC,29,1993,4.0,0,0,0,0,0,0,1,0.0,1,0,0,0,1,1,5,1,Matches
655,Ryan Raposo,ca CAN,DFFW,Vancouver W'caps,23,1999,14.8,19,13,7,7,5,9,18,50.0,9,15,4,11,22,41,33,0,Matches
656,Justin Rasmussen,us USA,DF,Portland Timbers,24,1998,3.7,9,8,6,2,1,5,10,50.0,5,3,1,2,3,12,8,0,Matches
657,Sean Rea,ca CAN,MFFW,CF Montréal,20,2002,8.3,5,3,2,2,1,0,4,0.0,4,7,0,7,2,7,0,0,Matches
658,Matthew Real,us USA,DFMF,Philadelphia Union,23,1999,5.5,14,7,7,5,2,9,12,75.0,3,13,5,8,3,17,7,0,Matches
659,Rodney Redes,py PAR,MFFW,Austin,22,2000,5.4,7,4,3,3,1,2,6,33.3,4,6,1,5,3,10,5,0,Matches
660,Jayden Reid,us USA,MF,NY Red Bulls,21,2001,0.0,0,0,0,0,0,0,0,,0,0,0,0,0,0,0,0,Matches
661,Justin Rennicks,us USA,FWMF,NE Revolution,23,1999,4.3,10,5,4,5,1,7,13,53.8,6,7,0,7,1,11,5,0,Matches
662,Andrés Reyes,co COL,DF,NY Red Bulls,23,1999,26.5,47,32,30,15,2,24,37,64.9,13,26,11,15,61,108,87,0,Matches
663,Emanuel Reynoso,ar ARG,MF,Minnesota Utd,27,1995,15.2,21,11,4,8,9,9,21,42.9,12,14,0,14,5,26,0,0,Matches
664,Spencer Richey,us USA,GK,Chicago Fire,30,1992,4.7,1,1,1,0,0,1,1,100.0,0,0,0,0,0,1,3,1,Matches
665,Emiliano Rigoni,ar ARG,FWMF,Austin,29,1993,24.3,22,16,9,9,4,10,25,40.0,15,23,4,19,5,27,35,0,Matches
666,Chris Rindov,us USA,DF,Sporting KC,21,2001,0.1,0,0,0,0,0,0,0,,0,1,1,0,0,0,0,0,Matches
667,Alexander Ring,fi FIN,DFMF,Austin,31,1991,23.9,37,24,25,9,3,20,47,42.6,27,27,17,10,27,64,69,2,Matches
668,Birk Risa,no NOR,DF,NYCFC,24,1998,9.6,9,4,6,3,0,6,11,54.5,5,4,3,1,8,17,33,0,Matches
669,Damien Rivera,cr CRC,FWMF,NE Revolution,20,2002,2.0,1,1,1,0,0,1,2,50.0,1,2,0,2,1,2,3,0,Matches
670,Nigel Robertha,nl NED,FWMF,D.C. United,24,1998,3.4,2,1,0,1,1,1,2,50.0,1,2,0,2,0,2,1,0,Matches
671,Miles Robinson,us USA,DF,Atlanta Utd,25,1997,26.3,36,24,23,10,3,15,26,57.7,11,26,19,7,25,61,99,0,Matches
672,Robbie Robinson,us USA,FWMF,Inter Miami,24,1998,3.8,7,4,4,3,0,1,7,14.3,6,2,1,1,1,8,1,0,Matches
673,Rodrigues,br BRA,DF,SJ Earthquakes,25,1997,33.3,72,46,56,15,1,48,74,64.9,26,43,27,16,58,130,152,1,Matches
674,Abraham Rodriguez,us USA,GK,Colorado Rapids,20,2002,1.0,0,0,0,0,0,0,0,,0,0,0,0,0,0,1,0,Matches
675,Memo Rodriguez,us USA,FWMF,Austin,27,1995,2.7,7,5,5,0,2,3,6,50.0,3,1,0,1,2,9,6,0,Matches
Rk
676,Memo Rodriguez,us USA,MFFW,LA Galaxy,27,1995,7.4,13,7,8,1,4,6,16,37.5,10,5,3,2,2,15,1,0,Matches
677,Missael Rodriguez,us USA,FW,Chicago Fire,19,2003,0.2,3,1,3,0,0,2,3,66.7,1,0,0,0,0,3,1,0,Matches
678,Santiago Rodríguez,uy URU,MFFW,NYCFC,23,2000,28.7,36,19,12,12,12,10,41,24.4,31,27,1,26,11,47,10,1,Matches
679,Alex Roldan,sv SLV,DF,Seattle Sounders,26,1996,26.9,53,38,24,22,7,33,59,55.9,26,25,5,20,23,76,51,1,Matches
680,Cristian Roldan,us USA,FWDF,Seattle Sounders,27,1995,13.9,22,14,10,9,3,10,21,47.6,11,14,0,14,9,31,14,0,Matches
681,Tomas Romero,sv SLV,GK,Toronto FC,22,2000,6.0,0,0,0,0,0,0,0,,0,0,0,0,0,0,5,2,Matches
682,David Romney,us USA,DF,NE Revolution,29,1993,34.0,23,14,15,7,1,19,34,55.9,15,50,31,19,37,60,162,2,Matches
683,Connor Ronan,ie IRL,MF,Colorado Rapids,24,1998,31.6,32,20,18,12,2,20,60,33.3,40,22,5,17,20,52,26,2,Matches
684,Eloy Room,cw CUW,GK,Columbus Crew,33,1989,3.0,0,0,0,0,0,0,0,,0,0,0,0,0,0,2,0,Matches
685,Joseph Rosales,hn HON,FWMF,Minnesota Utd,22,2000,12.1,32,22,10,18,4,14,27,51.9,13,19,2,17,12,44,14,1,Matches
686,Oriol Rosell,es ESP,MF,LA Galaxy,30,1992,9.4,18,11,8,7,3,5,17,29.4,12,13,3,10,6,24,14,1,Matches
687,Keegan Rosenberry,us USA,DF,Colorado Rapids,29,1993,25.2,32,24,12,16,4,21,38,55.3,17,24,13,11,46,78,54,0,Matches
688,Daniel Rosero,co COL,DF,Sporting KC,29,1993,25.1,28,13,19,8,1,17,34,50.0,17,34,23,11,34,62,103,2,Matches
689,Matheus Rossetto,br BRA,MF,Atlanta Utd,26,1996,20.3,54,32,21,27,6,18,39,46.2,21,19,2,17,17,71,23,1,Matches
690,Diego Rossi,uy URU,MFFW,Columbus Crew,24,1998,8.6,4,3,3,1,0,1,3,33.3,2,8,0,8,3,7,3,0,Matches
691,Sigurd Rosted,no NOR,DF,Toronto FC,28,1994,18.3,23,11,12,10,1,14,21,66.7,7,21,14,7,30,53,74,1,Matches
692,Paul Rothrock,us USA,FW,Seattle Sounders,24,1999,0.5,3,3,1,1,1,0,0,,0,0,0,0,0,3,0,0,Matches
693,Kelyn Rowe,us USA,DF,Seattle Sounders,31,1991,3.8,11,10,7,4,0,9,15,60.0,6,1,0,1,9,20,3,0,Matches
694,Ruan,br BRA,DFMF,D.C. United,27,1995,15.8,35,19,20,12,3,14,28,50.0,14,8,2,6,10,45,22,1,Matches
695,Rubio Rubin,gt GUA,FWMF,Real Salt Lake,26,1996,14.4,6,4,0,5,1,0,5,0.0,5,6,1,5,4,10,6,0,Matches
696,Diego Rubio,cl CHI,MFFW,Colorado Rapids,29,1993,11.9,17,12,5,10,2,5,13,38.5,8,8,1,7,6,23,18,0,Matches
697,Raúl Ruidíaz,pe PER,FW,Seattle Sounders,32,1990,11.7,6,2,3,2,1,2,10,20.0,8,12,0,12,0,6,3,0,Matches
698,Pablo Ruíz,ar ARG,MF,Real Salt Lake,24,1998,15.3,42,28,22,20,0,25,56,44.6,31,23,3,20,15,57,8,2,Matches
699,David Ruíz-Ochoa,hn HON,MF,Inter Miami,18,2004,13.2,31,22,13,11,7,12,32,37.5,20,13,2,11,13,44,2,0,Matches
700,Albert Rusnák,sk SVK,MFFW,Seattle Sounders,28,1994,29.1,18,8,6,8,4,7,30,23.3,23,13,2,11,22,40,5,0,Matches
Rk
701,Johnny Russell,sct SCO,FW,Sporting KC,32,1990,18.7,16,8,7,6,3,7,17,41.2,10,21,1,20,18,34,18,0,Matches
702,Jacen Russell-Rowe,ca CAN,FWMF,Columbus Crew,20,2002,6.0,7,4,1,3,3,3,9,33.3,6,6,0,6,2,9,2,0,Matches
703,Ryan Sailor,us USA,DFFW,Inter Miami,24,1998,3.4,4,2,2,2,0,1,1,100.0,0,3,2,1,3,7,27,1,Matches
704,Nathan-Dylan Saliba,ca CAN,MF,CF Montréal,18,2004,19.7,49,27,14,27,8,21,46,45.7,25,26,5,21,16,65,11,0,Matches
705,Abdi Salim,so SOM,DF,Orlando City,21,2001,1.6,4,2,2,1,1,3,3,100.0,0,2,1,1,4,8,3,0,Matches
706,Dániel Sallói,hu HUN,FW,Sporting KC,26,1996,31.9,18,16,6,7,5,8,20,40.0,12,24,5,19,16,34,21,0,Matches
707,Gaoussou Samaké,ci CIV,MFDF,D.C. United,25,1997,4.0,7,4,4,0,3,4,12,33.3,8,4,1,3,8,15,4,0,Matches
708,Ilie Sánchez,es ESP,MF,LAFC,32,1990,28.8,60,34,24,23,13,30,75,40.0,45,31,8,23,36,96,33,0,Matches
709,James Sands,us USA,MFDF,NYCFC,22,2000,24.1,59,36,28,28,3,25,48,52.1,23,38,10,28,26,85,29,0,Matches
710,William Sands,us USA,DFMF,Columbus Crew,22,2000,5.4,11,9,4,4,3,7,11,63.6,4,8,3,5,4,15,5,0,Matches
711,Jeong Sangbin,kr KOR,FWMF,Minnesota Utd,20,2002,10.7,4,2,1,0,3,2,3,66.7,1,2,0,2,7,11,3,0,Matches
712,Sergio Santos Gomes,br BRA,FWMF,FC Cincinnati,28,1994,10.0,18,16,3,11,4,2,5,40.0,3,6,0,6,1,19,6,0,Matches
713,Nuno Santos,pt POR,MF,Charlotte,23,1999,2.4,4,0,0,4,0,3,4,75.0,1,3,1,2,2,6,0,0,Matches
714,Pedro Santos,pt POR,DFMF,D.C. United,34,1988,16.7,56,40,34,20,2,35,65,53.8,30,22,2,20,10,66,23,1,Matches
715,Rafael Santos,br BRA,DF,Orlando City,24,1998,22.1,46,25,30,11,5,21,37,56.8,16,17,3,14,27,73,46,0,Matches
716,C.J. Sapong,us USA,FW,Toronto FC,34,1988,14.1,8,4,1,5,2,1,5,20.0,4,2,1,1,7,15,16,0,Matches
717,C.J. Sapong,us USA,FW,Nashville SC,34,1988,4.2,5,1,0,2,3,1,1,100.0,0,3,0,3,3,8,4,0,Matches
718,Hayden Sargis,us USA,DF,D.C. United,20,2002,0.2,0,0,0,0,0,0,0,,0,0,0,0,0,0,1,0,Matches
719,Jefferson Savarino,ve VEN,MFFW,Real Salt Lake,26,1996,21.6,18,16,7,7,4,7,23,30.4,16,6,0,6,4,22,4,0,Matches
720,Rodrigo Schlegel,ar ARG,DF,Orlando City,25,1997,21.9,34,14,20,9,5,20,34,58.8,14,23,15,8,24,58,92,1,Matches
721,Tate Schmitt,us USA,DF,Houston Dynamo,25,1997,4.4,4,2,2,1,1,1,2,50.0,1,4,0,4,4,8,4,0,Matches
722,Alessandro Schöpf,at AUT,MF,Vancouver W'caps,28,1994,19.7,38,20,16,17,5,14,32,43.8,18,24,5,19,16,54,16,0,Matches
723,Patrick Schulte,us USA,GK,Columbus Crew,21,2001,31.0,0,0,0,0,0,0,1,0.0,1,0,0,0,0,0,7,2,Matches
724,Dante Sealy,us USA,MFDF,FC Dallas,19,2003,3.2,7,5,1,5,1,3,8,37.5,5,6,3,3,1,8,7,0,Matches
725,Gabe Segal,us USA,FW,NYCFC,21,2001,4.6,8,7,1,3,4,4,6,66.7,2,3,0,3,1,9,2,0,Matches
Rk
726,Amar Sejdic,us USA,MF,Atlanta Utd,26,1996,11.8,18,12,9,7,2,6,29,20.7,23,17,3,14,12,30,7,0,Matches
727,Brandon Servania,us USA,MFFW,Toronto FC,23,1999,18.9,52,30,23,23,6,23,57,40.4,34,25,3,22,10,62,17,0,Matches
728,Jacob Shaffelburg,ca CAN,FWMF,Nashville SC,23,1999,14.6,9,5,2,3,4,5,22,22.7,17,21,0,21,16,25,6,0,Matches
729,Xherdan Shaqiri,ch SUI,MF,Chicago Fire,31,1991,22.8,10,6,6,4,0,2,10,20.0,8,12,2,10,5,15,1,2,Matches
730,Billy Sharp,eng ENG,FW,LA Galaxy,36,1986,7.9,2,1,0,2,0,0,1,0.0,1,4,3,1,0,2,7,0,Matches
731,Khiry Shelton,us USA,FWMF,Sporting KC,29,1993,9.4,8,5,1,6,1,2,6,33.3,4,5,0,5,16,24,10,0,Matches
732,Andre Shinyashiki,br BRA,MFFW,Charlotte,27,1995,2.1,6,3,1,5,0,3,9,33.3,6,2,0,2,1,7,0,0,Matches
733,Marcelo Silva,uy URU,DF,Real Salt Lake,33,1989,16.0,19,10,15,4,0,14,26,53.8,12,18,11,7,20,39,50,0,Matches
734,Xande Silva,pt POR,FW,Atlanta Utd,25,1997,7.1,4,0,0,2,2,1,6,16.7,5,1,0,1,4,8,7,0,Matches
735,Jonathan Sirois,ca CAN,GK,CF Montréal,21,2001,32.1,4,1,4,0,0,4,6,66.7,2,0,0,0,1,5,12,1,Matches
736,Pablo Sisniega,mx MEX,GK,Charlotte,27,1995,3.0,0,0,0,0,0,0,0,,0,0,0,0,0,0,2,0,Matches
737,Jack Skahan,us USA,FWMF,SJ Earthquakes,24,1998,4.0,3,3,2,1,0,1,5,20.0,4,4,0,4,3,6,2,0,Matches
738,Brad Smith,au AUS,DFFW,Houston Dynamo,28,1994,5.3,8,5,3,4,1,2,8,25.0,6,5,1,4,2,10,14,0,Matches
739,Collin Smith,us USA,DFMF,FC Dallas,19,2003,1.2,0,0,0,0,0,0,2,0.0,2,0,0,0,1,1,2,0,Matches
740,Kyle Smith,us USA,DF,Orlando City,31,1992,16.6,35,20,26,6,3,20,43,46.5,23,11,2,9,16,51,45,0,Matches
741,Jan Sobociński,pl POL,DF,Charlotte,23,1999,7.2,15,11,8,7,0,7,15,46.7,8,8,5,3,7,22,26,1,Matches
742,Santiago Sosa,ar ARG,MF,Atlanta Utd,23,1999,10.2,24,17,10,12,2,14,23,60.9,9,10,4,6,18,42,21,1,Matches
743,Arnaud Souquet,fr FRA,DF,Chicago Fire,30,1992,20.3,34,24,20,9,5,16,37,43.2,21,20,7,13,22,56,43,0,Matches
744,Ryan Spaulding,us USA,DF,NE Revolution,24,1998,6.9,5,3,2,2,1,2,3,66.7,1,9,0,9,5,10,17,0,Matches
745,Dayne St. Clair,ca CAN,GK,Minnesota Utd,25,1997,30.0,0,0,0,0,0,0,2,0.0,2,0,0,0,0,0,14,0,Matches
746,Mason Stajduhar,us USA,GK,Orlando City,25,1997,4.0,0,0,0,0,0,0,0,,0,0,0,0,0,0,2,1,Matches
747,Nicolás Stefanelli,ar ARG,FWMF,Inter Miami,28,1994,14.8,20,14,6,10,4,10,32,31.3,22,13,1,12,11,31,2,0,Matches
748,Lazar Stefanovic,ca CAN,DF,Toronto FC,16,2006,0.9,1,0,1,0,0,1,2,50.0,1,0,0,0,2,3,8,1,Matches
749,Daniel Steres,us USA,DF,Houston Dynamo,32,1990,20.7,38,26,24,14,0,20,31,64.5,11,30,9,21,17,55,59,0,Matches
750,Benjamin Stitz,us USA,FW,FC Cincinnati,22,2000,0.2,0,0,0,0,0,0,1,0.0,1,1,0,1,0,0,0,0,Matches
Rk
751,Jared Stroud,us USA,MFFW,St. Louis,26,1996,21.9,44,25,18,17,9,18,69,26.1,51,29,1,28,14,58,15,1,Matches
752,Peter Stroud,us USA,MF,NY Red Bulls,20,2002,11.3,30,24,8,22,0,16,28,57.1,12,17,2,15,21,51,3,0,Matches
753,Brad Stuver,us USA,GK,Austin,31,1991,34.0,2,1,2,0,0,0,0,,0,0,0,0,0,2,12,3,Matches
754,Yekeson Subah,lr LBR,FW,LAFC,18,2004,0.2,2,2,1,0,1,1,1,100.0,0,0,0,0,0,2,0,0,Matches
755,Quinn Sullivan,us USA,FWMF,Philadelphia Union,18,2004,7.7,7,5,1,6,0,2,9,22.2,7,8,0,8,6,13,4,0,Matches
756,Lawson Sunderland,us USA,MFFW,Inter Miami,21,2001,0.7,4,2,0,3,1,1,2,50.0,1,0,0,0,0,4,2,0,Matches
757,Sam Surridge,eng ENG,FW,Nashville SC,24,1998,5.5,3,3,1,2,0,0,2,0.0,2,1,0,1,0,3,8,0,Matches
758,Erik Sviatchenko,dk DEN,DF,Houston Dynamo,31,1991,15.0,9,5,8,1,0,6,12,50.0,6,17,8,9,11,20,58,0,Matches
759,Ben Sweat,us USA,DF,NE Revolution,31,1991,3.7,5,5,4,1,0,2,5,40.0,3,4,0,4,4,9,10,0,Matches
760,Ben Sweat,us USA,DF,Sporting KC,31,1991,3.5,2,2,1,1,0,0,4,0.0,4,2,0,2,5,7,11,0,Matches
761,Karol Świderski,pl POL,FWMF,Charlotte,26,1997,26.8,16,10,1,8,7,9,28,32.1,19,25,3,22,6,22,14,0,Matches
762,Nkosi Tafari,us USA,DF,FC Dallas,25,1997,27.7,25,11,20,5,0,18,24,75.0,6,32,22,10,24,49,122,1,Matches
763,Ismael Tajouri-Shradi,ly LBY,FW,Minnesota Utd,28,1994,3.9,5,3,3,1,1,1,7,14.3,6,3,0,3,0,5,2,0,Matches
764,Yohei Takaoka,jp JPN,GK,Vancouver W'caps,26,1996,33.0,1,1,1,0,0,1,1,100.0,0,1,0,1,0,1,9,2,Matches
765,Miguel Tapias,mx MEX,DF,Minnesota Utd,26,1997,31.8,41,31,35,6,0,27,44,61.4,17,39,30,9,37,78,160,0,Matches
766,Andrew Tarbell,us USA,GK,Houston Dynamo,29,1993,1.0,0,0,0,0,0,0,0,,0,0,0,0,0,0,0,0,Matches
767,Sidnei Tavares,pt POR,MF,Colorado Rapids,21,2001,3.3,2,0,1,0,1,1,5,20.0,4,2,0,2,1,3,0,0,Matches
768,D.J. Taylor,us USA,DF,Minnesota Utd,25,1997,27.9,66,46,40,21,5,38,63,60.3,25,25,13,12,31,97,86,0,Matches
769,Robert Taylor,fi FIN,FWDF,Inter Miami,28,1994,16.2,17,10,10,5,2,10,17,58.8,7,14,3,11,19,36,7,1,Matches
770,Russell Teibert,ca CAN,MF,Vancouver W'caps,30,1992,1.7,1,0,0,1,0,0,2,0.0,2,3,0,3,1,2,1,0,Matches
771,Carlos Terán,co COL,DF,Chicago Fire,22,2000,17.5,28,16,22,6,0,14,18,77.8,4,21,11,10,21,49,69,0,Matches
772,Dylan Teves,us USA,FW,Seattle Sounders,22,2000,4.3,3,3,1,0,2,1,7,14.3,6,5,1,4,1,4,0,0,Matches
773,Thiago,br BRA,FWMF,NYCFC,22,2000,1.5,4,2,3,1,0,0,1,0.0,1,2,1,1,0,4,1,0,Matches
774,Jamal Thiaré,sn SEN,FW,Atlanta Utd,29,1993,0.6,0,0,0,0,0,0,0,,0,1,0,1,1,1,1,0,Matches
775,Erik Thommy,de GER,MFFW,Sporting KC,28,1994,28.7,44,27,13,20,11,21,50,42.0,29,43,6,37,24,68,11,1,Matches
Rk
776,Kosi Thompson,ca CAN,MFFW,Toronto FC,20,2003,6.5,12,6,7,3,2,3,7,42.9,4,13,3,10,11,23,11,0,Matches
777,Tommy Thompson,us USA,MFDF,SJ Earthquakes,27,1995,3.9,7,6,5,1,1,4,9,44.4,5,2,0,2,2,9,11,0,Matches
778,Timmy Tillman,de GER,MF,LAFC,24,1999,18.3,41,25,15,22,4,19,52,36.5,33,27,2,25,17,58,12,0,Matches
779,John Tolkin,us USA,DF,NY Red Bulls,20,2002,26.4,54,34,34,16,4,35,53,66.0,18,26,4,22,26,80,44,0,Matches
780,Nouhou Tolo,cm CMR,DF,Seattle Sounders,25,1997,22.8,50,41,35,13,2,36,52,69.2,16,26,6,20,21,71,77,0,Matches
781,Facundo Torres,uy URU,FWMF,Orlando City,22,2000,26.3,15,10,6,4,5,7,27,25.9,20,14,0,14,9,24,5,1,Matches
782,Jairo Torres,mx MEX,MFFW,Chicago Fire,22,2000,8.5,7,4,4,1,2,3,15,20.0,12,5,0,5,6,13,10,1,Matches
783,Joaquín Torres,ar ARG,MFFW,Philadelphia Union,26,1997,3.9,4,4,1,1,2,1,2,50.0,1,3,0,3,2,6,0,0,Matches
784,Mason Toye,us USA,FW,CF Montréal,24,1998,7.5,2,1,0,1,1,1,1,100.0,0,3,0,3,2,4,3,0,Matches
785,Wil Trapp,us USA,MF,Minnesota Utd,30,1993,26.9,56,38,27,23,6,21,72,29.2,51,28,7,21,30,86,32,1,Matches
786,Miguel Trauco,pe PER,DF,SJ Earthquakes,30,1992,22.3,32,28,18,10,4,16,40,40.0,24,13,3,10,21,53,33,0,Matches
787,Niko Tsakiris,us USA,MF,SJ Earthquakes,17,2005,6.8,16,8,5,8,3,8,12,66.7,4,4,1,3,4,20,5,0,Matches
788,Bill Tuiloma,nz NZL,DF,Charlotte,27,1995,15.0,9,2,5,4,0,5,10,50.0,5,16,9,7,21,30,59,1,Matches
789,Stephen Turnbull,us USA,DFMF,NYCFC,24,1998,5.4,11,7,7,4,0,9,16,56.3,7,9,3,6,4,15,10,0,Matches
790,Ema Twumasi,gh GHA,DF,FC Dallas,25,1997,17.5,21,12,8,12,1,8,20,40.0,12,18,3,15,11,32,38,0,Matches
791,Marinos Tzionis,cy CYP,FWMF,Sporting KC,21,2001,8.1,21,11,4,11,6,8,21,38.1,13,12,2,10,3,24,4,0,Matches
792,Mikael Uhre,dk DEN,FW,Philadelphia Union,28,1994,23.8,23,13,3,15,5,6,20,30.0,14,17,0,17,9,32,19,0,Matches
793,Þorleifur Úlfarsson,is ISL,FWMF,Houston Dynamo,22,2000,5.3,1,1,0,1,0,0,6,0.0,6,1,0,1,2,3,4,0,Matches
794,Victor Ulloa,us USA,MF,Inter Miami,30,1992,1.8,6,3,4,2,0,4,11,36.4,7,1,1,0,2,8,2,0,Matches
795,Jere Uronen,fi FIN,DF,Charlotte,28,1994,6.8,8,5,3,4,1,2,7,28.6,5,8,4,4,9,17,12,0,Matches
796,Maximiliano Urruti,ar ARG,FW,Austin,31,1991,10.8,16,9,4,8,4,9,23,39.1,14,5,2,3,4,20,1,0,Matches
797,Júnior Urso,br BRA,MFFW,Orlando City,33,1989,2.8,5,3,2,3,0,3,5,60.0,2,2,0,2,2,7,5,0,Matches
798,Leo Väisänen,fi FIN,DF,Austin,25,1997,19.6,18,7,13,5,0,12,23,52.2,11,28,24,4,22,40,70,1,Matches
799,Jhojan Valencia,co COL,MF,Austin,26,1996,15.9,43,27,20,22,1,18,32,56.3,14,25,9,16,30,73,19,1,Matches
800,Zarek Valentin,pr PUR,DF,Minnesota Utd,31,1991,14.7,16,9,11,5,0,8,19,42.1,11,16,7,9,13,29,35,0,Matches
Rk
801,Gerardo Valenzuela,us USA,MF,FC Cincinnati,18,2004,0.1,1,0,1,0,0,1,1,100.0,0,0,0,0,1,2,0,0,Matches
802,Gustavo Vallecilla,ec ECU,DF,Columbus Crew,23,1999,9.4,17,12,11,6,0,10,22,45.5,12,12,5,7,10,27,16,0,Matches
803,Dante Vanzeir,be BEL,FWMF,NY Red Bulls,24,1998,8.3,5,3,0,2,3,2,11,18.2,9,3,1,2,3,8,5,0,Matches
804,Kerwin Vargas,co COL,FWMF,Charlotte,21,2002,16.5,8,7,2,3,3,2,14,14.3,12,18,0,18,20,28,14,0,Matches
805,Marlon Vargas,sv SLV,MF,Colorado Rapids,22,2001,0.1,0,0,0,0,0,0,0,,0,0,0,0,0,0,0,0,Matches
806,Obed Vargas,mx MEX,MF,Seattle Sounders,17,2005,14.7,36,22,14,17,5,16,36,44.4,20,18,3,15,17,53,12,0,Matches
807,Indiana Vassilev,us USA,MF,St. Louis,21,2001,23.5,46,27,21,22,3,27,65,41.5,38,29,4,25,10,56,8,1,Matches
808,Brandon Vazquez,us USA,FW,FC Cincinnati,24,1998,26.4,12,10,5,4,3,8,30,26.7,22,31,3,28,4,16,14,0,Matches
809,Víctor Vázquez,es ESP,MFFW,Toronto FC,36,1987,2.7,3,2,2,1,0,0,0,,0,1,1,0,2,5,2,1,Matches
810,Carlos Vela,mx MEX,FW,LAFC,33,1989,23.0,10,6,1,6,3,6,22,27.3,16,12,0,12,5,15,6,0,Matches
811,Alan Velasco,ar ARG,FWMF,FC Dallas,20,2002,25.1,45,29,25,13,7,19,60,31.7,41,23,0,23,20,65,14,0,Matches
812,Brayan Vera,co COL,DF,Real Salt Lake,24,1999,22.7,41,28,28,10,3,22,41,53.7,19,36,13,23,25,66,79,1,Matches
813,Ranko Veselinović,rs SRB,DF,Vancouver W'caps,23,1999,31.4,29,22,23,5,1,21,33,63.6,12,36,27,9,33,62,155,3,Matches
814,Jules-Anthony Vilsaint,ca CAN,FW,CF Montréal,20,2003,4.6,5,3,0,1,4,1,3,33.3,2,4,0,4,1,6,2,0,Matches
815,Pedro Vite,ec ECU,MFFW,Vancouver W'caps,20,2002,23.9,42,28,14,22,6,11,44,25.0,33,37,0,37,26,68,6,0,Matches
816,Gino Vivi,cr CRC,MFDF,LA Galaxy,22,2000,0.9,0,0,0,0,0,0,1,0.0,1,0,0,0,3,3,0,0,Matches
817,Robert Voloder,ba BIH,DF,Sporting KC,21,2001,11.4,18,5,13,2,3,9,18,50.0,9,13,5,8,21,39,33,2,Matches
818,Giacomo Vrioni,al ALB,FW,NE Revolution,24,1998,14.6,7,5,1,5,1,2,16,12.5,14,8,3,5,4,11,12,0,Matches
819,Kai Wagner,de GER,DF,Philadelphia Union,25,1997,27.1,60,39,31,23,6,36,63,57.1,27,47,17,30,46,106,30,0,Matches
820,Rémi Walter,fr FRA,MF,Sporting KC,27,1995,30.4,33,26,8,18,7,15,48,31.3,33,20,8,12,34,67,31,1,Matches
821,Victor Wanyama,ke KEN,MF,CF Montréal,31,1991,19.9,31,16,13,17,1,9,31,29.0,22,12,2,10,23,54,24,1,Matches
822,Taylor Washington,us USA,DFMF,Nashville SC,29,1993,5.4,10,5,7,3,0,5,7,71.4,2,5,2,3,10,20,16,0,Matches
823,Joel Waterman,ca CAN,DF,CF Montréal,27,1996,26.4,32,19,18,12,2,20,34,58.8,14,52,33,19,31,63,87,0,Matches
824,Akil Watts,us USA,DFMF,St. Louis,22,2000,9.8,31,18,18,9,4,14,29,48.3,15,8,2,6,14,45,26,0,Matches
825,Quentin Westberg,us USA,GK,Atlanta Utd,36,1986,5.5,0,0,0,0,0,0,0,,0,0,0,0,0,0,1,0,Matches
Rk
826,Ashley Westwood,eng ENG,MF,Charlotte,32,1990,28.1,15,9,5,8,2,8,23,34.8,15,16,6,10,10,25,18,1,Matches
827,Brian White,us USA,FW,Vancouver W'caps,26,1996,28.2,21,11,1,13,7,5,16,31.3,11,22,4,18,4,25,24,0,Matches
828,Caleb Wiley,us USA,DFFW,Atlanta Utd,18,2004,25.9,41,26,23,10,8,26,49,53.1,23,26,6,20,29,70,35,0,Matches
829,Derrick Williams,ie IRL,DF,D.C. United,30,1993,20.5,20,11,13,6,1,12,21,57.1,9,23,16,7,25,45,74,1,Matches
830,Eryk Williamson,us USA,MF,Portland Timbers,25,1997,5.9,11,7,4,7,0,2,7,28.6,5,8,0,8,4,15,2,0,Matches
831,Joe Willis,us USA,GK,Nashville SC,34,1988,32.0,0,0,0,0,0,0,1,0.0,1,0,0,0,0,0,3,1,Matches
832,Danny Wilson,sct SCO,DF,Colorado Rapids,31,1991,25.7,24,9,14,9,1,8,25,32.0,17,42,26,16,21,45,107,1,Matches
833,Owen Wolff,us USA,MF,Austin,18,2004,20.9,27,12,15,11,1,15,39,38.5,24,23,6,17,23,50,21,1,Matches
834,Tyler Wolff,us USA,FWMF,Atlanta Utd,19,2003,7.2,19,9,7,11,1,8,23,34.8,15,9,2,7,4,23,3,0,Matches
835,Bobby Wood,us USA,FW,NE Revolution,30,1992,16.5,9,5,1,6,2,5,12,41.7,7,7,3,4,3,12,13,0,Matches
836,Karifa Yao,ca CAN,MF,Vancouver W'caps,22,2000,0.0,0,0,0,0,0,0,0,,0,0,0,0,0,0,0,0,Matches
837,Darren Yapi,us USA,FWMF,Colorado Rapids,18,2004,9.9,11,10,3,6,2,3,11,27.3,8,4,1,3,2,13,11,0,Matches
838,William Yarbrough,us USA,GK,Colorado Rapids,33,1989,20.0,0,0,0,0,0,0,2,0.0,2,0,0,0,0,0,13,1,Matches
839,Joshua Yaro,gh GHA,DF,St. Louis,28,1994,10.1,23,17,16,5,2,10,12,83.3,2,13,6,7,18,41,48,0,Matches
840,Dru Yearwood,eng ENG,MF,NY Red Bulls,22,2000,9.2,20,13,8,9,3,5,13,38.5,8,8,1,7,17,37,3,1,Matches
841,Yaw Yeboah,gh GHA,DFMF,Columbus Crew,25,1997,22.0,31,21,11,16,4,19,54,35.2,35,23,1,22,20,51,5,0,Matches
842,DeAndre Yedlin,us USA,DF,Inter Miami,29,1993,25.8,40,22,21,14,5,22,47,46.8,25,34,8,26,31,71,50,0,Matches
843,Maya Yoshida,jp JPN,DF,LA Galaxy,34,1988,12.0,10,9,6,3,1,4,10,40.0,6,16,10,6,26,36,50,0,Matches
844,Jackson Yueill,us USA,MF,SJ Earthquakes,25,1997,30.2,40,23,13,18,9,18,46,39.1,28,21,4,17,32,72,29,0,Matches
845,Gyasi Zardes,us USA,FW,Austin,31,1991,16.3,13,8,3,8,2,8,17,47.1,9,8,1,7,1,14,16,0,Matches
846,Eriq Zavaleta,sv SLV,DF,LA Galaxy,30,1992,5.4,4,4,3,1,0,3,8,37.5,5,2,2,0,5,9,16,0,Matches
847,Sean Zawadzki,us USA,DFMF,Columbus Crew,22,2000,17.5,33,21,12,15,6,15,23,65.2,8,22,6,16,35,68,34,1,Matches
848,Lucas Zelarayán,am ARM,MFFW,Columbus Crew,30,1992,18.9,21,9,6,12,3,6,27,22.2,21,10,0,10,7,28,8,0,Matches
849,Walker Zimmerman,us USA,DF,Nashville SC,29,1993,20.5,31,19,23,7,1,12,24,50.0,12,31,19,12,32,63,100,0,Matches
850,Rida Zouhir,ca CAN,MFFW,CF Montréal,19,2003,2.5,5,3,1,2,2,1,3,33.3,2,1,0,1,2,7,2,0,Matches
Rk
851,Ethan Zubak,us USA,FW,Nashville SC,24,1998,1.6,2,1,1,1,0,2,2,100.0,0,0,0,0,0,2,5,0,Matches
852,Dario Župarić,ba BIH,DF,Portland Timbers,30,1992,31.0,34,24,25,6,3,20,32,62.5,12,35,17,18,41,75,104,0,Matches
853,Graham Zusi,us USA,DF,Sporting KC,36,1986,9.6,19,14,11,6,2,14,22,63.6,8,12,4,8,11,30,25,0,Matches
854,Nökkvi Þórisson,is ISL,FWMF,St. Louis,23,1999,3.0,8,1,4,3,1,2,6,33.3,4,7,0,7,3,11,2,0,Matches
855,Róbert Þorkelsson,is ISL,DF,CF Montréal,20,2002,2.5,7,5,7,0,0,3,7,42.9,4,5,0,5,3,10,4,0,Matches
